date,year,league,expected_score,home_team,guest_team,home_team_score,guest_team_score,home_team_quarter1_score,guest_team_quarter1_score,home_team_quarter2_score,guest_team_quarter2_score,home_team_quarter3_score,guest_team_quarter3_score,home_team_quarter4_score,guest_team_quarter4_score,total_quarter1_score,total_quarter2_score,total_quarter3_score,total_quarter4_score,2nd_half_under
16.09.2025,2025,isr,163,Bnei Herzliya,Maccabi Ironi Ramat Gan,81,69,24,27,16,19,27,9,14,14,51,35,36,28,-1
16.09.2025,2025,isr,159,Hapoel Beer Sheva,H. Afula,78,86,23,26,16,17,18,20,21,23,49,33,38,44,1
15.09.2025,2025,isr,163,Gilboa Galil,Hapoel Jerusalem,80,90,15,22,20,21,24,19,21,28,37,41,43,49,1
14.09.2025,2025,isr,161,Nes Ziona,Galil Elyon,89,65,17,14,27,14,16,17,29,20,31,41,33,49,1
13.09.2025,2025,isr,158,H. Afula,Ironi Kiryat Ata,67,91,12,30,14,20,17,22,24,19,42,34,39,43,1
16.09.2025,2025,isr,163,Maccabi Ironi Ramat Gan,x,81,69,24,27,16,19,27,9,14,14,51,35,36,28,-1
16.09.2025,2025,isr,159,H. Afula,x,78,86,23,26,16,17,18,20,21,23,49,33,38,44,1
15.09.2025,2025,isr,163,Hapoel Jerusalem,x,80,90,15,22,20,21,24,19,21,28,37,41,43,49,1
14.09.2025,2025,isr,161,Galil Elyon,x,89,65,17,14,27,14,16,17,29,20,31,41,33,49,1
13.09.2025,2025,isr,158,Ironi Kiryat Ata,x,67,91,12,30,14,20,17,22,24,19,42,34,39,43,1
16.09.2025,2025,tur b,152,Çağdaş Bodrum Spor,MKE Ankaragucu,65,64,12,18,22,14,9,19,22,13,30,36,28,35,-1
15.09.2025,2025,tur b,153,OGM Ormanspor,Ankara Kolejliler,72,64,17,19,19,21,19,7,17,17,36,40,26,34,-1
15.09.2025,2025,tur b,155,Gaziantep,Sigortam.net ITU,79,82,15,27,26,32,20,12,18,11,42,58,32,29,-1
15.09.2025,2025,tur b,157,Trabzonspor,Kapakli Spor,66,77,16,17,12,19,17,17,21,24,33,31,34,45,1
14.09.2025,2025,tur b,158,Harem Spor,Esenler Erokspor,64,86,14,18,13,23,17,25,20,20,32,36,42,40,1
14.09.2025,2025,tur b,158,Balikesir,Final Spor,77,65,16,11,18,16,18,23,25,15,27,34,41,40,1
14.09.2025,2025,tur b,163,Fenerbahce 2,Konya BBSK,75,73,15,18,12,24,23,8,25,23,33,36,31,48,-1
14.09.2025,2025,tur b,157,Cayirova,Istanbul Anka Spor,86,59,16,22,20,11,30,11,20,15,38,31,41,35,-1
13.09.2025,2025,tur b,146,CO Basket,Bordo Sportif,78,71,24,15,16,10,13,21,25,25,39,26,34,50,1
16.09.2025,2025,tur b,152,MKE Ankaragucu,x,65,64,12,18,22,14,9,19,22,13,30,36,28,35,-1
15.09.2025,2025,tur b,153,Ankara Kolejliler,x,72,64,17,19,19,21,19,7,17,17,36,40,26,34,-1
15.09.2025,2025,tur b,155,iLab Basketbol,x,79,82,15,27,26,32,20,12,18,11,42,58,32,29,-1
15.09.2025,2025,tur b,157,Kapakli Spor,x,66,77,16,17,12,19,17,17,21,24,33,31,34,45,1
14.09.2025,2025,tur b,158,Esenler Erokspor,x,64,86,14,18,13,23,17,25,20,20,32,36,42,40,1
14.09.2025,2025,tur b,158,Final Spor,x,77,65,16,11,18,16,18,23,25,15,27,34,41,40,1
14.09.2025,2025,tur b,163,Konya BBSK,x,75,73,15,18,12,24,23,8,25,23,33,36,31,48,-1
14.09.2025,2025,tur b,157,Istanbul Anka Spor,x,86,59,16,22,20,11,30,11,20,15,38,31,41,35,-1
13.09.2025,2025,tur b,146,Bordo Sportif,x,78,71,24,15,16,10,13,21,25,25,39,26,34,50,1
16.09.2025,2025,vietnam,158,Hanoi Buffaloes,Can Tho Catfish,59,75,15,25,11,26,16,9,17,15,40,37,25,32,-1
15.09.2025,2025,vietnam,160,Saigon Heat,Nhatrang Dolphins,84,82,24,21,19,18,20,19,21,24,45,37,39,45,1
11.09.2025,2025,vietnam,160,Hanoi Buffaloes,Can Tho Catfish,60,82,14,22,11,23,8,17,27,20,36,34,25,47,-1
09.09.2025,2025,vietnam,158,Hanoi Buffaloes,Can Tho Catfish,88,77,20,20,18,17,25,21,25,19,40,35,46,44,1
06.09.2025,2025,vietnam,165,Nhatrang Dolphins,Da Nang Dragons,94,79,21,20,30,14,24,23,19,22,41,44,47,41,1
03.09.2025,2025,vietnam,166,Hanoi Buffaloes,Nhatrang Dolphins,72,100,21,28,19,31,16,20,16,21,49,50,36,37,-1
02.09.2025,2025,vietnam,173,Da Nang Dragons,Ho Chi Minh City Wings,91,80,22,15,19,22,19,19,31,24,37,41,38,55,1
15.09.2025,2025,kazak,,Astana,Almaty,87,76,11,14,20,19,26,28,30,15,25,39,54,45,
15.09.2025,2025,kazak,,Aktobe,Kaspiy Aktau,60,75,13,19,14,12,21,21,12,23,32,26,42,35,
15.09.2025,2025,kazak,,Tobol Kostanay,Atyrau,73,64,19,20,19,12,15,25,20,7,39,31,40,27,
14.09.2025,2025,kazak,,Kaspiy Aktau,Astana,75,80,12,11,23,22,14,22,26,25,23,45,36,51,
14.09.2025,2025,kazak,,Almaty,Tobol Kostanay,107,112,24,17,18,24,21,27,27,22,41,42,48,49,
14.09.2025,2025,kazak,,Atyrau,Aktobe,75,45,15,16,23,10,23,9,14,10,31,33,32,24,
13.09.2025,2025,kazak,,Tobol Kostanay,Astana,72,112,18,36,20,24,21,28,13,24,54,44,49,37,
13.09.2025,2025,kazak,,Aktobe,Almaty,64,102,13,32,16,27,15,19,20,24,45,43,34,44,
13.09.2025,2025,kazak,,Atyrau,Kaspiy Aktau,65,59,14,11,21,18,11,20,19,10,25,39,31,29,
16.09.2025,2025,vietnam,158,Can Tho Catfish,x,59,75,15,25,11,26,16,9,17,15,40,37,25,32,-1
15.09.2025,2025,vietnam,160,Nhatrang Dolphins,x,84,82,24,21,19,18,20,19,21,24,45,37,39,45,1
11.09.2025,2025,vietnam,160,Can Tho Catfish,x,60,82,14,22,11,23,8,17,27,20,36,34,25,47,-1
09.09.2025,2025,vietnam,158,Can Tho Catfish,x,88,77,20,20,18,17,25,21,25,19,40,35,46,44,1
06.09.2025,2025,vietnam,165,Da Nang Dragons,x,94,79,21,20,30,14,24,23,19,22,41,44,47,41,1
03.09.2025,2025,vietnam,166,Nhatrang Dolphins,x,72,100,21,28,19,31,16,20,16,21,49,50,36,37,-1
02.09.2025,2025,vietnam,173,Ho Chi Minh City Wings,x,91,80,22,15,19,22,19,19,31,24,37,41,38,55,1
15.09.2025,2025,kazak,,Almaty,x,87,76,11,14,20,19,26,28,30,15,25,39,54,45,
15.09.2025,2025,kazak,,Kaspiy Aktau,x,60,75,13,19,14,12,21,21,12,23,32,26,42,35,
15.09.2025,2025,kazak,,Atyrau,x,73,64,19,20,19,12,15,25,20,7,39,31,40,27,
14.09.2025,2025,kazak,,Astana,x,75,80,12,11,23,22,14,22,26,25,23,45,36,51,
14.09.2025,2025,kazak,,Tobol Kostanay,x,107,112,24,17,18,24,21,27,27,22,41,42,48,49,
14.09.2025,2025,kazak,,Aktobe,x,75,45,15,16,23,10,23,9,14,10,31,33,32,24,
13.09.2025,2025,kazak,,Astana,x,72,112,18,36,20,24,21,28,13,24,54,44,49,37,
13.09.2025,2025,kazak,,Almaty,x,64,102,13,32,16,27,15,19,20,24,45,43,34,44,
13.09.2025,2025,kazak,,Kaspiy Aktau,x,65,59,14,11,21,18,11,20,19,10,25,39,31,29,
17.09.2025,2025,fiba,158,Petkim Spor,Den Bosch,92,72,24,17,27,25,19,14,22,16,41,52,33,38,-1
17.09.2025,2025,fiba,161,Caledonia Gladiators,CSM Oradea,59,90,11,18,15,33,17,13,16,26,29,48,30,42,-1
17.09.2025,2025,fiba,158,Sabah Baku,Norrkoping,71,75,18,15,19,18,11,23,23,19,33,37,34,42,-1
17.09.2025,2025,fiba,156,Rilski Sportist,BC Nokia,71,64,21,17,21,15,15,16,14,16,38,36,31,30,-1
17.09.2025,2025,rus cup,,Khimki-Podmoskovie,BC Moscow,51,75,8,17,9,23,15,21,19,14,25,32,36,33,
17.09.2025,2025,rus cup,,Cheboksary,Ufa,48,65,14,15,8,15,10,21,16,14,29,23,31,30,
17.09.2025,2025,rus cup,,Desna Bryansk,Saratov 2,75,59,12,13,20,10,24,13,19,23,25,30,37,42,
17.09.2025,2025,rus cup,,Dynamo MGTU,Dynamo Stavropol,65,90,24,20,15,13,13,30,13,27,44,28,43,40,
17.09.2025,2025,friendly,159,Leyma Coruna (Esp),FC Porto (Por),88,85,14,9,18,19,24,20,17,25,23,37,44,42,1
17.09.2025,2025,friendly,160,Ponferrada (Esp),Oviedo (Esp),66,74,17,17,18,19,18,19,13,19,34,37,37,32,-1
17.09.2025,2025,friendly,157,AEK Athens (Gre),Fenerbahce (Tur),75,85,21,23,18,21,22,21,14,20,44,39,43,34,-1
17.09.2025,2025,friendly,156,AEL (Cyp),Apollon (Cyp),77,79,28,21,15,22,15,13,19,23,49,37,28,42,-1
17.09.2025,2025,friendly,148,Apoel BC (Cyp),Anorthosis (Cyp),74,63,20,17,17,20,19,12,18,14,37,37,31,32,-1
17.09.2025,2025,friendly,167,Dinamo Zagreb (Cro),Alftanes (Ice),91,84,27,25,27,20,20,21,17,18,52,47,41,35,-1
17.09.2025,2025,friendly,165,Elitzur Shomron (Isr),Ironi Nahariya (Isr),73,71,18,22,15,14,22,12,18,23,40,29,34,41,-1
16.09.2025,2025,friendly,166,Panathinaikos (Gre),Maccabi Tel Aviv (Isr),75,88,22,30,22,17,11,11,20,30,52,39,22,50,-1
17.09.2025,2025,fiba,158,Den Bosch,x,92,72,24,17,27,25,19,14,22,16,41,52,33,38,-1
17.09.2025,2025,fiba,161,CSM Oradea,x,59,90,11,18,15,33,17,13,16,26,29,48,30,42,-1
17.09.2025,2025,fiba,158,Norrkoping,x,71,75,18,15,19,18,11,23,23,19,33,37,34,42,-1
17.09.2025,2025,fiba,156,BC Nokia,x,71,64,21,17,21,15,15,16,14,16,38,36,31,30,-1
17.09.2025,2025,rus cup,,BC Moscow,x,51,75,8,17,9,23,15,21,19,14,25,32,36,33,
17.09.2025,2025,rus cup,,Ufa,x,48,65,14,15,8,15,10,21,16,14,29,23,31,30,
17.09.2025,2025,rus cup,,Saratov 2,x,75,59,12,13,20,10,24,13,19,23,25,30,37,42,
17.09.2025,2025,rus cup,,Dynamo Stavropol,x,65,90,24,20,15,13,13,30,13,27,44,28,43,40,
17.09.2025,2025,friendly,159,FC Porto (Por),x,88,85,14,9,18,19,24,20,17,25,23,37,44,42,1
17.09.2025,2025,friendly,160,Oviedo (Esp),x,66,74,17,17,18,19,18,19,13,19,34,37,37,32,-1
17.09.2025,2025,friendly,157,Fenerbahce (Tur),x,75,85,21,23,18,21,22,21,14,20,44,39,43,34,-1
17.09.2025,2025,friendly,156,Apollon (Cyp),x,77,79,28,21,15,22,15,13,19,23,49,37,28,42,-1
17.09.2025,2025,friendly,148,Anorthosis (Cyp),x,74,63,20,17,17,20,19,12,18,14,37,37,31,32,-1
17.09.2025,2025,friendly,167,Alftanes (Ice),x,91,84,27,25,27,20,20,21,17,18,52,47,41,35,-1
17.09.2025,2025,friendly,165,Ironi Nahariya (Isr),x,73,71,18,22,15,14,22,12,18,23,40,29,34,41,-1
16.09.2025,2025,friendly,166,Maccabi Tel Aviv (Isr),x,75,88,22,30,22,17,11,11,20,30,52,39,22,50,-1
18.09.2025,2025,w nba,165,Los Angeles Sparks W,Phoenix Mercury W,81,85,14,14,30,22,10,28,27,21,28,52,38,48,1
18.09.2025,2025,w nba,163,Seattle Storm W,Las Vegas Aces W,72,85,18,29,22,19,21,15,11,22,47,41,36,33,-1
18.09.2025,2025,w nba,151,Atlanta Dream W,Chicago Sky W,86,70,22,14,24,18,14,20,26,18,36,42,34,44,1
18.09.2025,2025,w nba,153,Connecticut Sun W,Minnesota Lynx W,76,78,22,22,15,20,16,20,23,16,44,35,36,39,-1
18.09.2025,2025,w nba,162,Washington Mystics W,New York Liberty W,71,87,18,29,19,18,17,25,17,15,47,37,42,32,-1
18.09.2025,2025,w nba,165,Phoenix Mercury W,x,81,85,14,14,30,22,10,28,27,21,28,52,38,48,1
18.09.2025,2025,w nba,163,Las Vegas Aces W,x,72,85,18,29,22,19,21,15,11,22,47,41,36,33,-1
18.09.2025,2025,w nba,151,Chicago Sky W,x,86,70,22,14,24,18,14,20,26,18,36,42,34,44,1
18.09.2025,2025,w nba,153,Minnesota Lynx W,x,76,78,22,22,15,20,16,20,23,16,44,35,36,39,-1
18.09.2025,2025,w nba,162,New York Liberty W,x,71,87,18,29,19,18,17,25,17,15,47,37,42,32,-1
20.09.2025,2025,w nba,169,Las Vegas Aces W,Dallas Wings W,98,84,30,30,30,15,28,23,10,16,60,45,51,26,-1
20.09.2025,2025,w nba,165,Phoenix Mercury W,Seattle Storm W,70,89,14,35,17,8,18,25,21,21,49,25,43,42,1
20.09.2025,2025,w nba,159,Minnesota Lynx W,Los Angeles Sparks W,51,68,13,19,17,19,14,15,7,15,32,36,29,22,-1
20.09.2025,2025,w nba,152,Connecticut Sun W,Chicago Sky W,87,54,20,15,26,20,23,6,18,13,35,46,29,31,-1
20.09.2025,2025,w nba,157,New York Liberty W,Atlanta Dream W,67,78,15,21,15,22,19,23,18,12,36,37,42,30,-1
20.09.2025,2025,w nba,168,Washington Mystics W,Indiana Fever W,92,91,22,24,30,21,30,21,10,25,46,51,51,35,1
20.09.2025,2025,w nba,169,Dallas Wings W,x,98,84,30,30,30,15,28,23,10,16,60,45,51,26,-1
20.09.2025,2025,w nba,165,Seattle Storm W,x,70,89,14,35,17,8,18,25,21,21,49,25,43,42,1
20.09.2025,2025,w nba,159,Los Angeles Sparks W,x,51,68,13,19,17,19,14,15,7,15,32,36,29,22,-1
20.09.2025,2025,w nba,152,Chicago Sky W,x,87,54,20,15,26,20,23,6,18,13,35,46,29,31,-1
20.09.2025,2025,w nba,157,Atlanta Dream W,x,67,78,15,21,15,22,19,23,18,12,36,37,42,30,-1
20.09.2025,2025,w nba,168,Indiana Fever W,x,92,91,22,24,30,21,30,21,10,25,46,51,51,35,1
19.09.2025,2025,fiba,162,Cholet,Petkim Spor,70,76,21,24,15,11,20,20,14,21,45,26,40,35,-1
19.09.2025,2025,fiba,157,PAOK,CSM Oradea,81,80,19,24,25,21,22,25,15,10,43,46,47,25,-1
19.09.2025,2025,fiba,155,Fribourg Olympic,Norrkoping,80,79,25,19,19,21,24,18,12,21,44,40,42,33,-1
19.09.2025,2025,fiba,153,Benfica,Rilski Sportist,89,88,28,24,19,16,15,23,27,25,52,35,38,52,1
18.09.2025,2025,fiba,158,Subotica,Juventus,84,87,22,23,23,14,19,23,20,27,45,37,42,47,1
18.09.2025,2025,fiba,155,MoraBanc Andorra,Antwerp Giants,91,73,26,20,25,18,29,21,11,14,46,43,50,25,-1
18.09.2025,2025,fiba,160,Kutaisi,Levice,87,111,21,30,21,25,23,26,22,30,51,46,49,52,1
18.09.2025,2025,fiba,148,Trepca,Keravnos,82,79,23,14,21,30,19,12,19,23,37,51,31,42,-1
19.09.2025,2025,fiba,162,Petkim Spor,x,70,76,21,24,15,11,20,20,14,21,45,26,40,35,-1
19.09.2025,2025,fiba,157,CSM Oradea,x,81,80,19,24,25,21,22,25,15,10,43,46,47,25,-1
19.09.2025,2025,fiba,155,Norrkoping,x,80,79,25,19,19,21,24,18,12,21,44,40,42,33,-1
19.09.2025,2025,fiba,153,Rilski Sportist,x,89,88,28,24,19,16,15,23,27,25,52,35,38,52,1
18.09.2025,2025,fiba,158,Juventus,x,84,87,22,23,23,14,19,23,20,27,45,37,42,47,1
18.09.2025,2025,fiba,155,Antwerp Giants,x,91,73,26,20,25,18,29,21,11,14,46,43,50,25,-1
18.09.2025,2025,fiba,160,Levice,x,87,111,21,30,21,25,23,26,22,30,51,46,49,52,1
18.09.2025,2025,fiba,148,Keravnos,x,82,79,23,14,21,30,19,12,19,23,37,51,31,42,-1
19.09.2025,2025,friendly,152,KKS Tarnowskie Gory (Pol),Bielsko Biala (Pol),48,56,11,14,15,6,15,14,7,22,25,21,29,29,-1
19.09.2025,2025,friendly,168,Forca Lleida (Esp),Manresa (Esp),81,76,17,22,23,12,24,20,17,22,39,35,44,39,-1
19.09.2025,2025,friendly,159,Tofas (Tur),Darussafaka (Tur),107,92,28,23,31,28,22,18,26,23,51,59,40,49,1
19.09.2025,2025,friendly,162,Bursaspor (Tur),Mersin BŞB (Tur),93,97,20,19,27,25,23,26,23,27,39,52,49,50,1
19.09.2025,2025,friendly,162,FUS Rabat (Mar),Al Wahda (Uae),89,75,22,27,18,17,30,15,19,16,49,35,45,35,-1
18.09.2025,2025,friendly,159,Estudiantes (Esp),Real Valladolid (Esp),79,78,17,13,17,24,24,24,21,17,30,41,48,38,1
18.09.2025,2025,friendly,162,Urania Milano (Ita),Assigeco Piacenza (Ita),88,76,29,12,22,26,10,23,27,15,41,48,33,42,-1
18.09.2025,2025,friendly,158,Gipuzkoa (Esp),Bilbao (Esp),73,96,22,25,24,23,13,21,14,27,47,47,34,41,-1
18.09.2025,2025,friendly,154,Tenerife (Esp),Gran Canaria (Esp),84,81,17,13,23,18,24,24,20,26,30,41,48,46,1
18.09.2025,2025,friendly,166,Basket Zaragoza (Esp),Valencia (Esp),89,86,18,29,23,28,23,13,25,16,47,51,36,41,-1
18.09.2025,2025,friendly,149,Paralimni (Cyp),ETHA Engomi (Cyp),76,73,18,16,14,21,24,14,20,22,34,35,38,42,1
18.09.2025,2025,friendly,152,AEK Larnaca (Cyp),Anorthosis (Cyp),72,63,25,15,21,20,15,7,11,21,40,41,22,32,-1
19.09.2025,2025,friendly,152,Bielsko Biala (Pol),x,48,56,11,14,15,6,15,14,7,22,25,21,29,29,-1
19.09.2025,2025,friendly,168,Manresa (Esp),x,81,76,17,22,23,12,24,20,17,22,39,35,44,39,-1
19.09.2025,2025,friendly,159,Darussafaka (Tur),x,107,92,28,23,31,28,22,18,26,23,51,59,40,49,1
19.09.2025,2025,friendly,162,Mersin BŞB (Tur),x,93,97,20,19,27,25,23,26,23,27,39,52,49,50,1
19.09.2025,2025,friendly,162,Al Wahda (Uae),x,89,75,22,27,18,17,30,15,19,16,49,35,45,35,-1
18.09.2025,2025,friendly,159,Real Valladolid (Esp),x,79,78,17,13,17,24,24,24,21,17,30,41,48,38,1
18.09.2025,2025,friendly,162,Assigeco Piacenza (Ita),x,88,76,29,12,22,26,10,23,27,15,41,48,33,42,-1
18.09.2025,2025,friendly,158,Bilbao (Esp),x,73,96,22,25,24,23,13,21,14,27,47,47,34,41,-1
18.09.2025,2025,friendly,154,Gran Canaria (Esp),x,84,81,17,13,23,18,24,24,20,26,30,41,48,46,1
18.09.2025,2025,friendly,166,Valencia (Esp),x,89,86,18,29,23,28,23,13,25,16,47,51,36,41,-1
18.09.2025,2025,friendly,149,ETHA Engomi (Cyp),x,76,73,18,16,14,21,24,14,20,22,34,35,38,42,1
18.09.2025,2025,friendly,152,Anorthosis (Cyp),x,72,63,25,15,21,20,15,7,11,21,40,41,22,32,-1
18.09.2025,2025,bnxt,152,Circus Brussels,Oostende,72,82,19,24,12,18,14,23,27,17,43,30,37,44,1
14.09.2025,2025,bnxt,153,Belfius Mons,Limburg,78,83,23,23,20,17,18,21,17,22,46,37,39,39,1
14.09.2025,2025,bnxt,152,Okapi Aalst,Leuven Bears,51,64,16,15,12,16,8,15,15,18,31,28,23,33,-1
14.09.2025,2025,bnxt,151,Oostende,Spirou Charleroi,83,71,19,20,29,15,20,26,15,10,39,44,46,25,-1
14.09.2025,2025,bnxt,146,BAL Weert,Zwolle,80,89,19,22,23,20,29,23,9,24,41,43,52,33,1
14.09.2025,2025,bnxt,154,Leiden,Kortrijk,84,86,19,29,18,15,22,19,25,23,48,33,41,48,1
14.09.2025,2025,bnxt,158,LWD Basket,Donar Groningen,64,73,26,12,7,19,13,17,18,25,38,26,30,43,-1
14.09.2025,2025,bnxt,160,Feyenoord,Yoast Utd,76,77,18,24,19,22,22,17,17,14,42,41,39,31,-1
13.09.2025,2025,bnxt,154,Antwerp Giants,Den Helder,64,75,23,18,9,19,23,16,9,22,41,28,39,31,-1
13.09.2025,2025,bnxt,151,Den Bosch,Circus Brussels,76,81,16,21,21,14,16,21,23,25,37,35,37,48,1
18.09.2025,2025,bnxt,152,Oostende,x,72,82,19,24,12,18,14,23,27,17,43,30,37,44,1
14.09.2025,2025,bnxt,153,Limburg,x,78,83,23,23,20,17,18,21,17,22,46,37,39,39,1
14.09.2025,2025,bnxt,152,Leuven Bears,x,51,64,16,15,12,16,8,15,15,18,31,28,23,33,-1
14.09.2025,2025,bnxt,151,Spirou Charleroi,x,83,71,19,20,29,15,20,26,15,10,39,44,46,25,-1
14.09.2025,2025,bnxt,146,Zwolle,x,80,89,19,22,23,20,29,23,9,24,41,43,52,33,1
14.09.2025,2025,bnxt,154,Kortrijk,x,84,86,19,29,18,15,22,19,25,23,48,33,41,48,1
14.09.2025,2025,bnxt,158,Donar Groningen,x,64,73,26,12,7,19,13,17,18,25,38,26,30,43,-1
14.09.2025,2025,bnxt,160,QSTA Utd,x,76,77,18,24,19,22,22,17,17,14,42,41,39,31,-1
13.09.2025,2025,bnxt,154,Den Helder,x,64,75,23,18,9,19,23,16,9,22,41,28,39,31,-1
13.09.2025,2025,bnxt,151,Circus Brussels,x,76,81,16,21,21,14,16,21,23,25,37,35,37,48,1
14.09.2025,2025,fra b,157,Ada Blois,Denain-Voltaire,83,70,23,16,18,19,25,17,17,18,39,37,42,35,-1
14.09.2025,2025,fra b,152,Boulazac,Chalons-Reims,79,62,17,16,18,22,24,12,20,12,33,40,36,32,-1
14.09.2025,2025,fra b,155,Orleans,Antibes,78,71,27,12,20,15,10,24,21,20,39,35,34,41,-1
13.09.2025,2025,fra b,160,ASA,St. Chamond,99,94,20,26,22,29,27,23,30,16,46,51,50,46,1
13.09.2025,2025,fra b,151,Hyeres-Toulon,Rouen,63,85,13,16,19,25,17,20,14,24,29,44,37,38,-1
13.09.2025,2025,fra b,153,Caen,Poitiers,95,91,23,22,12,17,29,21,20,24,45,29,50,44,1
13.09.2025,2025,fra b,152,Evreux,Fos-sur-Mer,75,85,16,17,15,23,21,14,23,31,33,38,35,54,1
13.09.2025,2025,fra b,165,Nantes,Aix Maurienne,74,87,20,25,11,22,20,14,23,26,45,33,34,49,1
13.09.2025,2025,fra b,154,Pau-Orthez,Vichy,75,71,19,21,25,13,18,21,13,16,40,38,39,29,-1
13.09.2025,2025,fra b,153,Roanne,Chartres,108,71,22,13,23,23,31,14,32,21,35,46,45,53,1
14.09.2025,2025,fra b,157,Denain-Voltaire,x,83,70,23,16,18,19,25,17,17,18,39,37,42,35,-1
14.09.2025,2025,fra b,152,Chalons-Reims,x,79,62,17,16,18,22,24,12,20,12,33,40,36,32,-1
14.09.2025,2025,fra b,155,Antibes,x,78,71,27,12,20,15,10,24,21,20,39,35,34,41,-1
13.09.2025,2025,fra b,160,St. Chamond,x,99,94,20,26,22,29,27,23,30,16,46,51,50,46,1
13.09.2025,2025,fra b,151,Rouen,x,63,85,13,16,19,25,17,20,14,24,29,44,37,38,-1
13.09.2025,2025,fra b,153,Poitiers,x,95,91,23,22,12,17,29,21,20,24,45,29,50,44,1
13.09.2025,2025,fra b,152,Fos-sur-Mer,x,75,85,16,17,15,23,21,14,23,31,33,38,35,54,1
13.09.2025,2025,fra b,165,Aix Maurienne,x,74,87,20,25,11,22,20,14,23,26,45,33,34,49,1
13.09.2025,2025,fra b,154,Vichy,x,75,71,19,21,25,13,18,21,13,16,40,38,39,29,-1
13.09.2025,2025,fra b,153,Chartres,x,108,71,22,13,23,23,31,14,32,21,35,46,45,53,1
20.09.2025,2025,fiba,158,Sassari,Juventus,77,73,23,14,17,18,19,16,18,25,37,35,35,43,-1
20.09.2025,2025,fiba,162,Bonn,MoraBanc Andorra,99,91,20,18,31,22,16,21,32,30,38,53,37,62,1
20.09.2025,2025,fiba,156,BC Kalev/Cramo,Levice,84,76,23,14,21,17,17,18,23,27,37,38,35,50,1
20.09.2025,2025,fiba,158,Nymburk,Trepca,84,78,20,17,20,18,21,19,23,24,37,38,40,47,1
20.09.2025,2025,fiba,158,Juventus,x,77,73,23,14,17,18,19,16,18,25,37,35,35,43,-1
20.09.2025,2025,fiba,162,MoraBanc Andorra,x,99,91,20,18,31,22,16,21,32,30,38,53,37,62,1
20.09.2025,2025,fiba,156,Levice,x,84,76,23,14,21,17,17,18,23,27,37,38,35,50,1
20.09.2025,2025,fiba,158,Trepca,x,84,78,20,17,20,18,21,19,23,24,37,38,40,47,1
20.09.2025,2025,aba,157,Cibona,Zadar,69,87,17,27,23,15,10,23,19,22,44,38,33,41,-1
20.09.2025,2025,aba,157,Zadar,x,69,87,17,27,23,15,10,23,19,22,44,38,33,41,-1
20.09.2025,2025,bnxt,154,Kortrijk,BAL Weert,115,75,30,16,28,22,31,22,26,15,46,50,53,41,1
20.09.2025,2025,bnxt,154,Limburg,Mechelen,74,65,20,20,19,10,23,20,12,15,40,29,43,27,-1
20.09.2025,2025,bnxt,154,Spirou Charleroi,Feyenoord,106,60,30,13,19,15,29,14,28,18,43,34,43,46,1
20.09.2025,2025,bnxt,154,BAL Weert,x,115,75,30,16,28,22,31,22,26,15,46,50,53,41,1
20.09.2025,2025,bnxt,154,Mechelen,x,74,65,20,20,19,10,23,20,12,15,40,29,43,27,-1
20.09.2025,2025,bnxt,154,Feyenoord,x,106,60,30,13,19,15,29,14,28,18,43,34,43,46,1
20.09.2025,2025,fra b,155,Antibes,ASA,73,72,20,11,13,23,21,15,19,23,31,36,36,42,1
20.09.2025,2025,fra b,163,St. Chamond,Orleans,92,71,24,17,20,17,23,18,25,19,41,37,41,44,1
20.09.2025,2025,fra b,154,Vichy,Ada Blois,58,71,22,12,15,16,10,20,11,23,34,31,30,34,-1
20.09.2025,2025,fra b,154,Denain-Voltaire,Caen,79,68,30,17,20,14,9,17,20,20,47,34,26,40,-1
20.09.2025,2025,fra b,162,Aix Maurienne,Hyeres-Toulon,97,82,17,26,30,23,18,14,32,19,43,53,32,51,1
20.09.2025,2025,fra b,152,Fos-sur-Mer,Pau-Orthez,64,78,8,22,11,23,22,11,23,22,30,34,33,45,1
20.09.2025,2025,fra b,159,Poitiers,Evreux,86,74,26,15,24,22,21,13,15,24,41,46,34,39,-1
20.09.2025,2025,fra b,152,Rouen,Boulazac,67,71,18,13,17,20,18,20,14,18,31,37,38,32,-1
20.09.2025,2025,fra b,155,ASA,x,73,72,20,11,13,23,21,15,19,23,31,36,36,42,1
20.09.2025,2025,fra b,163,Orleans,x,92,71,24,17,20,17,23,18,25,19,41,37,41,44,1
20.09.2025,2025,fra b,154,Ada Blois,x,58,71,22,12,15,16,10,20,11,23,34,31,30,34,-1
20.09.2025,2025,fra b,154,Caen,x,79,68,30,17,20,14,9,17,20,20,47,34,26,40,-1
20.09.2025,2025,fra b,162,Hyeres-Toulon,x,97,82,17,26,30,23,18,14,32,19,43,53,32,51,1
20.09.2025,2025,fra b,152,Pau-Orthez,x,64,78,8,22,11,23,22,11,23,22,30,34,33,45,1
20.09.2025,2025,fra b,159,Evreux,x,86,74,26,15,24,22,21,13,15,24,41,46,34,39,-1
20.09.2025,2025,fra b,152,Boulazac,x,67,71,18,13,17,20,18,20,14,18,31,37,38,32,-1
20.09.2025,2025,rus cup,,Tobolsk,TSK Ural,77,38,24,9,18,6,22,13,13,10,33,24,35,23,
20.09.2025,2025,rus cup,,Parma Perm,Enisey 2,87,55,24,17,18,13,22,12,23,13,41,31,34,36,
19.09.2025,2025,rus cup,,Parma Perm,Tobolsk,70,84,22,17,20,30,9,18,19,19,39,50,27,38,
19.09.2025,2025,rus cup,,Unics Kazan 2,Cheboksary,49,67,10,19,16,17,11,14,12,17,29,33,25,29,
19.09.2025,2025,rus cup,,Saratov 2,BC Moscow,41,84,8,18,7,19,16,22,10,25,26,26,38,35,
19.09.2025,2025,rus cup,,Enisey 2,TSK Ural,58,62,21,12,8,13,18,22,11,15,33,21,40,26,
19.09.2025,2025,rus cup,,Samara 2,Dynamo MGTU,80,54,22,12,18,13,13,15,27,14,34,31,28,41,
19.09.2025,2025,rus cup,,Khimki-Podmoskovie,Desna Bryansk,85,69,16,25,29,19,19,16,21,9,41,48,35,30,
18.09.2025,2025,rus cup,,Tobolsk,Enisey 2,86,63,30,12,21,23,22,16,13,12,42,44,38,25,
18.09.2025,2025,rus cup,,BC Moscow,Desna Bryansk,87,57,27,14,17,17,18,3,25,23,41,34,21,48,
18.09.2025,2025,rus cup,,TSK Ural,Parma Perm,60,61,19,14,7,9,17,17,17,21,33,16,34,38,
18.09.2025,2025,rus cup,,Ufa,Unics Kazan 2,92,64,14,24,21,8,27,15,30,17,38,29,42,47,
18.09.2025,2025,rus cup,,Saratov 2,Khimki-Podmoskovie,62,73,16,10,17,30,15,16,14,17,26,47,31,31,
18.09.2025,2025,rus cup,,Dynamo Stavropol,Samara 2,83,88,27,25,21,24,19,20,16,19,52,45,39,35,
20.09.2025,2025,rus cup,,TSK Ural,x,77,38,24,9,18,6,22,13,13,10,33,24,35,23,
20.09.2025,2025,rus cup,,Enisey 2,x,87,55,24,17,18,13,22,12,23,13,41,31,34,36,
19.09.2025,2025,rus cup,,Tobolsk,x,70,84,22,17,20,30,9,18,19,19,39,50,27,38,
19.09.2025,2025,rus cup,,Cheboksary,x,49,67,10,19,16,17,11,14,12,17,29,33,25,29,
19.09.2025,2025,rus cup,,BC Moscow,x,41,84,8,18,7,19,16,22,10,25,26,26,38,35,
19.09.2025,2025,rus cup,,TSK Ural,x,58,62,21,12,8,13,18,22,11,15,33,21,40,26,
19.09.2025,2025,rus cup,,Dynamo MGTU,x,80,54,22,12,18,13,13,15,27,14,34,31,28,41,
19.09.2025,2025,rus cup,,Desna Bryansk,x,85,69,16,25,29,19,19,16,21,9,41,48,35,30,
18.09.2025,2025,rus cup,,Enisey 2,x,86,63,30,12,21,23,22,16,13,12,42,44,38,25,
18.09.2025,2025,rus cup,,Desna Bryansk,x,87,57,27,14,17,17,18,3,25,23,41,34,21,48,
18.09.2025,2025,rus cup,,Parma Perm,x,60,61,19,14,7,9,17,17,17,21,33,16,34,38,
18.09.2025,2025,rus cup,,Unics Kazan 2,x,92,64,14,24,21,8,27,15,30,17,38,29,42,47,
18.09.2025,2025,rus cup,,Khimki-Podmoskovie,x,62,73,16,10,17,30,15,16,14,17,26,47,31,31,
18.09.2025,2025,rus cup,,Samara 2,x,83,88,27,25,21,24,19,20,16,19,52,45,39,35,
20.09.2025,2025,friendly,153,Esgueira (Por),Ovarense (Por),80,87,16,25,27,25,16,28,21,9,41,52,44,30,-1
20.09.2025,2025,friendly,152,Breogan (Esp),Ourense (Esp),78,69,22,23,19,14,22,17,15,15,45,33,39,30,-1
20.09.2025,2025,friendly,156,Tamis (Srb),Radnicki (Srb),72,89,21,24,21,19,13,25,17,21,45,40,38,38,-1
20.09.2025,2025,friendly,165,Baskonia (Esp),Trieste (Ita),93,76,29,25,28,23,21,14,15,14,54,51,35,29,-1
20.09.2025,2025,friendly,170,Lublin (Pol),GTK Gliwice (Pol),78,73,24,23,20,17,16,16,18,17,47,37,32,35,-1
20.09.2025,2025,friendly,155,Leyma Coruna (Esp),Obradoiro CAB (Esp),84,79,18,27,23,18,20,18,23,16,45,41,38,39,-1
20.09.2025,2025,friendly,162,Fenerbahce (Tur),Manisa (Tur),122,90,30,21,28,28,35,15,29,26,51,56,50,55,1
20.09.2025,2025,friendly,155,Peristeri (Gre),Panionios (Gre),73,74,19,13,20,27,17,19,17,15,32,47,36,32,-1
20.09.2025,2025,friendly,,Aris (Gre),AS Karditsas (Gre),69,74,26,13,17,17,10,18,16,26,39,34,28,42,
20.09.2025,2025,friendly,164,Dabrowa Gornicza (Pol),Dziki Warszawa (Pol),57,74,15,21,19,11,13,22,10,20,36,30,35,30,-1
20.09.2025,2025,friendly,152,Merkezefendi (Tur),Promitheas (Gre),87,101,21,31,24,20,29,22,13,28,52,44,51,41,1
20.09.2025,2025,friendly,,KK Mladost SP (Srb),Minyor (Bul),78,65,23,17,16,19,19,12,20,17,40,35,31,37,
20.09.2025,2025,friendly,,Liaoning (Chn),Shenzhen (Chn),67,62,12,20,18,8,18,14,19,20,32,26,32,39,
20.09.2025,2025,friendly,,Xinjiang (Chn),Sichuan (Chn),88,66,27,19,22,14,20,18,19,15,46,36,38,34,
20.09.2025,2025,friendly,,Zhejiang Guangsha (Chn),Shanxi Zhongyu (Chn),70,74,14,22,17,17,23,20,16,15,36,34,43,31,
20.09.2025,2025,friendly,171,Fujian (Chn),Tianjin (Chn),81,84,27,27,9,21,18,21,27,15,54,30,39,42,-1
20.09.2025,2025,friendly,162,Jiangsu Dragons (Chn),Zhejiang Chouzhou (Chn),58,83,10,24,16,22,9,23,23,14,34,38,32,37,-1
20.09.2025,2025,friendly,,Jilin (Chn),Beijing Royal Fighters (Chn),65,78,17,23,18,18,12,22,18,15,40,36,34,33,
20.09.2025,2025,friendly,,Maccabi Rishon (Isr),Ramat Hasharon (Isr),91,89,22,24,21,19,22,28,26,18,46,40,50,44,
20.09.2025,2025,friendly,,Beijing (Chn),Ningbo Rockets (Chn),76,56,26,11,11,19,26,9,13,17,37,30,35,30,
20.09.2025,2025,friendly,,Guangdong (Chn),Guangzhou (Chn),89,76,25,22,15,21,28,18,21,15,47,36,46,36,
20.09.2025,2025,friendly,,Qingdao (Chn),Nanjing Tongxi (Chn),81,89,18,23,25,25,17,20,21,21,41,50,37,42,
20.09.2025,2025,friendly,,Shanghai (Chn),Shandong (Chn),69,66,16,19,20,21,17,9,16,17,35,41,26,33,
20.09.2025,2025,friendly,153,Ovarense (Por),x,80,87,16,25,27,25,16,28,21,9,41,52,44,30,-1
20.09.2025,2025,friendly,152,Ourense (Esp),x,78,69,22,23,19,14,22,17,15,15,45,33,39,30,-1
20.09.2025,2025,friendly,156,Radnicki (Srb),x,72,89,21,24,21,19,13,25,17,21,45,40,38,38,-1
20.09.2025,2025,friendly,165,Trieste (Ita),x,93,76,29,25,28,23,21,14,15,14,54,51,35,29,-1
20.09.2025,2025,friendly,170,GTK Gliwice (Pol),x,78,73,24,23,20,17,16,16,18,17,47,37,32,35,-1
20.09.2025,2025,friendly,155,Obradoiro CAB (Esp),x,84,79,18,27,23,18,20,18,23,16,45,41,38,39,-1
20.09.2025,2025,friendly,162,Manisa (Tur),x,122,90,30,21,28,28,35,15,29,26,51,56,50,55,1
20.09.2025,2025,friendly,155,Panionios (Gre),x,73,74,19,13,20,27,17,19,17,15,32,47,36,32,-1
20.09.2025,2025,friendly,,AS Karditsas (Gre),x,69,74,26,13,17,17,10,18,16,26,39,34,28,42,
20.09.2025,2025,friendly,164,Dziki Warszawa (Pol),x,57,74,15,21,19,11,13,22,10,20,36,30,35,30,-1
20.09.2025,2025,friendly,152,Promitheas (Gre),x,87,101,21,31,24,20,29,22,13,28,52,44,51,41,1
20.09.2025,2025,friendly,,Minyor (Bul),x,78,65,23,17,16,19,19,12,20,17,40,35,31,37,
20.09.2025,2025,friendly,,Shenzhen (Chn),x,67,62,12,20,18,8,18,14,19,20,32,26,32,39,
20.09.2025,2025,friendly,,Sichuan (Chn),x,88,66,27,19,22,14,20,18,19,15,46,36,38,34,
20.09.2025,2025,friendly,,Shanxi Zhongyu (Chn),x,70,74,14,22,17,17,23,20,16,15,36,34,43,31,
20.09.2025,2025,friendly,171,Tianjin (Chn),x,81,84,27,27,9,21,18,21,27,15,54,30,39,42,-1
20.09.2025,2025,friendly,162,Zhejiang Chouzhou (Chn),x,58,83,10,24,16,22,9,23,23,14,34,38,32,37,-1
20.09.2025,2025,friendly,,Beijing Royal Fighters (Chn),x,65,78,17,23,18,18,12,22,18,15,40,36,34,33,
20.09.2025,2025,friendly,,Ramat Hasharon (Isr),x,91,89,22,24,21,19,22,28,26,18,46,40,50,44,
20.09.2025,2025,friendly,,Ningbo Rockets (Chn),x,76,56,26,11,11,19,26,9,13,17,37,30,35,30,
20.09.2025,2025,friendly,,Guangzhou (Chn),x,89,76,25,22,15,21,28,18,21,15,47,36,46,36,
20.09.2025,2025,friendly,,Nanjing Tongxi (Chn),x,81,89,18,23,25,25,17,20,21,21,41,50,37,42,
20.09.2025,2025,friendly,,Shandong (Chn),x,69,66,16,19,20,21,17,9,16,17,35,41,26,33,
22.09.2025,2025,friendly,,Obera TC (Arg),Riachuelo (Arg),82,77,19,19,20,16,19,21,24,21,38,36,40,45,
21.09.2025,2025,friendly,164,Panathinaikos (Gre),Partizan (Srb),64,75,8,15,19,21,16,21,21,18,23,40,37,39,-1
21.09.2025,2025,friendly,166,Trento (Ita),Brescia (Ita),100,88,24,17,24,20,28,34,24,17,41,44,62,41,1
21.09.2025,2025,friendly,162,Anadolu Efes (Tur),Maccabi Tel Aviv (Isr),89,66,21,20,18,18,32,15,18,13,41,36,47,31,-1
21.09.2025,2025,friendly,149,Apoel BC (Cyp),Paralimni (Cyp),83,98,22,29,21,20,24,21,16,28,51,41,45,44,1
21.09.2025,2025,friendly,165,Sagesse Beirut (Leb),FUS Rabat (Mar),82,78,24,29,23,11,12,17,23,21,53,34,29,44,-1
21.09.2025,2025,friendly,168,Tofas (Tur),Mersin BŞB (Tur),84,79,20,28,27,18,14,19,23,14,48,45,33,37,-1
21.09.2025,2025,friendly,166,Karsiyaka (Tur),Merkezefendi (Tur),94,51,19,12,26,11,12,16,37,12,31,37,28,49,-1
21.09.2025,2025,friendly,162,Sichuan (Chn),Qingdao (Chn),92,99,22,18,18,22,27,28,25,31,40,40,55,56,1
21.09.2025,2025,friendly,166,Bursaspor (Tur),Darussafaka (Tur),103,99,24,24,28,17,27,30,24,28,48,45,57,52,1
21.09.2025,2025,friendly,166,Guangzhou (Chn),Fujian (Chn),62,108,19,19,13,29,12,30,18,30,38,42,42,48,1
21.09.2025,2025,friendly,149,Liaoning (Chn),Ningbo Rockets (Chn),99,79,31,15,13,26,31,19,24,19,46,39,50,43,1
21.09.2025,2025,friendly,157,Zhejiang Chouzhou (Chn),Shanghai (Chn),85,68,27,12,18,28,22,15,18,13,39,46,37,31,-1
21.09.2025,2025,friendly,158,Al Wahda (Uae),Al Bashaer (Oma),101,102,28,15,23,24,15,21,22,28,43,47,36,50,1
21.09.2025,2025,friendly,161,Nanjing Tongxi (Chn),Xinjiang (Chn),93,96,19,26,26,31,22,18,26,21,45,57,40,47,1
21.09.2025,2025,friendly,150,Shanxi Zhongyu (Chn),Jilin (Chn),102,93,26,18,17,27,33,23,26,25,44,44,56,51,1
21.09.2025,2025,friendly,145,Shenzhen (Chn),Beijing (Chn),77,83,23,28,19,18,19,25,16,12,51,37,44,28,-1
21.09.2025,2025,friendly,165,Tianjin (Chn),Guangdong (Chn),74,89,22,25,18,16,15,17,19,31,47,34,32,50,-1
21.09.2025,2025,friendly,147,Jiangsu Dragons (Chn),Shandong (Chn),68,86,18,31,17,17,15,22,18,16,49,34,37,34,-1
21.09.2025,2025,friendly,164,Partizan (Srb),x,64,75,8,15,19,21,16,21,21,18,23,40,37,39,-1
21.09.2025,2025,friendly,166,Brescia (Ita),x,100,88,24,17,24,20,28,34,24,17,41,44,62,41,1
21.09.2025,2025,friendly,162,Maccabi Tel Aviv (Isr),x,89,66,21,20,18,18,32,15,18,13,41,36,47,31,-1
21.09.2025,2025,friendly,149,Paralimni (Cyp),x,83,98,22,29,21,20,24,21,16,28,51,41,45,44,1
21.09.2025,2025,friendly,165,FUS Rabat (Mar),x,82,78,24,29,23,11,12,17,23,21,53,34,29,44,-1
21.09.2025,2025,friendly,168,Mersin BŞB (Tur),x,84,79,20,28,27,18,14,19,23,14,48,45,33,37,-1
21.09.2025,2025,friendly,166,Merkezefendi (Tur),x,94,51,19,12,26,11,12,16,37,12,31,37,28,49,-1
21.09.2025,2025,friendly,162,Qingdao (Chn),x,92,99,22,18,18,22,27,28,25,31,40,40,55,56,1
21.09.2025,2025,friendly,166,Darussafaka (Tur),x,103,99,24,24,28,17,27,30,24,28,48,45,57,52,1
21.09.2025,2025,friendly,166,Fujian (Chn),x,62,108,19,19,13,29,12,30,18,30,38,42,42,48,1
21.09.2025,2025,friendly,149,Ningbo Rockets (Chn),x,99,79,31,15,13,26,31,19,24,19,46,39,50,43,1
21.09.2025,2025,friendly,157,Shanghai (Chn),x,85,68,27,12,18,28,22,15,18,13,39,46,37,31,-1
21.09.2025,2025,friendly,158,Al Bashaer (Oma),x,101,102,28,15,23,24,15,21,22,28,43,47,36,50,1
21.09.2025,2025,friendly,161,Xinjiang (Chn),x,93,96,19,26,26,31,22,18,26,21,45,57,40,47,1
21.09.2025,2025,friendly,150,Jilin (Chn),x,102,93,26,18,17,27,33,23,26,25,44,44,56,51,1
21.09.2025,2025,friendly,145,Beijing (Chn),x,77,83,23,28,19,18,19,25,16,12,51,37,44,28,-1
21.09.2025,2025,friendly,165,Guangdong (Chn),x,74,89,22,25,18,16,15,17,19,31,47,34,32,50,-1
21.09.2025,2025,friendly,147,Shandong (Chn),x,68,86,18,31,17,17,15,22,18,16,49,34,37,34,-1
23.09.2025,2025,friendly,159,Ryukyu (Jpn),LG Sakers (Kor),84,88,24,18,21,20,22,22,17,28,42,41,44,45,1
23.09.2025,2025,friendly,,Union De Santa Fe (Arg),Obera TC (Arg),72,107,17,27,22,27,9,29,24,24,44,49,38,48,
22.09.2025,2025,friendly,156,Trapani (Ita),Olympiacos (Gre),90,95,25,24,23,27,22,22,20,22,49,50,44,42,1
22.09.2025,2025,friendly,156,AEK Athens (Gre),Peristeri (Gre),75,87,23,10,21,21,13,27,18,29,33,42,40,47,1
22.09.2025,2025,friendly,157,Ovarense (Por),Oliveirense (Por),84,71,20,22,22,19,13,14,29,16,42,41,27,45,-1
22.09.2025,2025,friendly,162,Al Wahda (Uae),Sagesse Beirut (Leb),55,89,17,25,12,17,15,27,11,20,42,29,42,31,-1
22.09.2025,2025,friendly,171,Nanjing Tongxi (Chn),Sichuan (Chn),90,73,31,12,22,22,17,16,20,23,43,44,33,43,-1
22.09.2025,2025,friendly,157,Beijing (Chn),Liaoning (Chn),69,67,16,20,13,13,16,20,24,14,36,26,36,38,-1
22.09.2025,2025,friendly,167,Guangdong (Chn),Fujian (Chn),85,83,27,25,14,26,15,19,29,13,52,40,34,42,-1
22.09.2025,2025,friendly,152,Shanxi Zhongyu (Chn),Beijing Royal Fighters (Chn),104,72,32,16,34,11,28,27,10,18,48,45,55,28,1
22.09.2025,2025,friendly,156,Zhejiang Chouzhou (Chn),Shandong (Chn),76,86,18,20,21,20,22,19,15,27,38,41,41,42,1
22.09.2025,2025,friendly,166,FUS Rabat (Mar),Al Bashaer (Oma),82,56,21,18,17,9,16,10,28,19,39,26,26,47,-1
22.09.2025,2025,friendly,164,Guangzhou (Chn),Tianjin (Chn),67,89,22,18,15,26,11,24,19,21,40,41,35,40,-1
22.09.2025,2025,friendly,155,Ningbo Rockets (Chn),Shenzhen (Chn),76,96,18,33,16,27,18,23,24,13,51,43,41,37,1
22.09.2025,2025,friendly,174,Xinjiang (Chn),Qingdao (Chn),97,72,25,17,21,22,24,16,27,17,42,43,40,44,-1
22.09.2025,2025,friendly,147,Zhejiang Guangsha (Chn),Jilin (Chn),68,85,12,12,18,20,19,27,19,26,24,38,46,45,1
22.09.2025,2025,friendly,151,Jiangsu Dragons (Chn),Shanghai (Chn),72,83,18,20,22,17,15,21,17,25,38,39,36,42,1
22.09.2025,2025,friendly,159,Obera TC (Arg),Riachuelo (Arg),82,77,19,19,20,16,19,21,24,21,38,36,40,45,1
22.09.2025,2025,avst,183,Adelaide,Sydney,94,102,28,27,20,24,27,19,19,32,55,44,46,51,1
21.09.2025,2025,avst,180,Cairns Taipans,Illawarra Hawks,75,102,21,26,24,28,15,18,15,30,47,52,33,45,-1
21.09.2025,2025,avst,176,New Zealand Breakers,Brisbane Bullets,91,87,24,19,27,15,21,18,19,35,43,42,39,54,1
20.09.2025,2025,avst,189,Perth,South East Melbourne,106,98,29,17,24,27,27,21,26,33,46,51,48,59,1
19.09.2025,2025,avst,173,Melbourne United,Tasmania JackJumpers,88,79,23,20,22,23,27,16,16,20,43,45,43,36,-1
22.09.2025,2025,cek,166,Srsni Pisek,Brno,95,74,29,23,28,13,16,22,22,16,52,41,38,38,-1
21.09.2025,2025,cek,163,Decin,NH Ostrava,103,94,25,25,29,28,22,18,27,23,50,57,40,50,1
21.09.2025,2025,cek,161,Olomoucko,Pardubice,93,88,27,19,22,23,22,21,22,25,46,45,43,47,1
21.09.2025,2025,cek,156,USK Prague,Jindrichuv Hradec,98,86,30,22,19,19,19,20,30,25,52,38,39,55,1
22.09.2025,2025,fiba,162,Bonn,Sassari,78,71,20,21,12,12,32,15,14,23,41,24,47,37,1
22.09.2025,2025,fiba,156,Nymburk,BC Kalev/Cramo,80,66,11,21,23,22,26,10,20,13,32,45,36,33,-1
21.09.2025,2025,fiba,160,PAOK,Petkim Spor,69,79,22,12,8,17,23,21,16,29,34,25,44,45,1
21.09.2025,2025,fiba,156,Benfica,Fribourg Olympic,91,85,28,26,24,15,14,25,25,19,54,39,39,44,1
20.09.2025,2025,fiba,158,Sassari,Juventus,77,73,23,14,17,18,19,16,18,25,37,35,35,43,-1
22.09.2025,2025,aba,167,FMP Beograd,Cedevita Olimpija,75,62,21,20,12,20,26,8,16,14,41,32,34,30,-1
22.09.2025,2025,aba,164,KK Krka Novo mesto,Mega Basket,70,80,19,16,14,23,16,18,21,23,35,37,34,44,-1
22.09.2025,2025,aba,163,Dubai,Crvena zvezda,86,84,28,16,22,25,16,22,20,21,44,47,38,41,-1
21.09.2025,2025,aba,163,Mornar Bar,Buducnost,51,98,20,24,8,26,10,25,13,23,44,34,35,36,-1
21.09.2025,2025,aba,156,Split,Igokea,74,79,14,14,18,21,31,24,11,20,28,39,55,31,1
20.09.2025,2025,aba,157,Cibona,Zadar,69,87,17,27,23,15,10,23,19,22,44,38,33,41,-1
22.09.2025,2025,bnxt,156,QSTA Utd,Oostende,61,102,19,29,17,29,11,25,14,19,48,46,36,33,-1
22.09.2025,2025,bnxt,152,Zwolle,Okapi Aalst,90,82,22,17,18,25,21,16,29,24,39,43,37,53,1
21.09.2025,2025,bnxt,150,Den Helder,Leiden,79,80,18,13,20,8,7,24,16,16,31,28,31,32,-1
21.09.2025,2025,bnxt,153,Donar Groningen,Belfius Mons,79,92,11,24,28,27,18,19,22,22,35,55,37,44,1
20.09.2025,2025,bnxt,155,Kortrijk,BAL Weert,115,75,30,16,28,22,31,22,26,15,46,50,53,41,1
20.09.2025,2025,bnxt,154,Limburg,Mechelen,74,65,20,20,19,10,23,20,12,15,40,29,43,27,-1
20.09.2025,2025,bnxt,154,Spirou Charleroi,Feyenoord,106,60,30,13,19,15,29,14,28,18,43,34,43,46,1
18.09.2025,2025,bnxt,152,Circus Brussels,Oostende,72,82,19,24,12,18,14,23,27,17,43,30,37,44,1
22.09.2025,2025,fra,160,Limoges,Nanterre,90,87,18,26,21,19,22,18,29,24,44,40,40,53,1
22.09.2025,2025,fra,154,Gravelines-Dunkerque,Paris,89,85,24,22,20,24,25,23,20,16,46,44,48,36,1
22.09.2025,2025,fra,156,Lyon-Villeurbanne,Le Mans,85,71,18,23,25,14,25,19,17,15,41,39,44,32,-1
21.09.2025,2025,fra,152,Nancy,La Rochelle,64,56,16,18,17,10,14,18,17,10,34,27,32,27,-1
21.09.2025,2025,fra,160,Strasbourg,Chalon/Saone,83,80,21,17,21,23,26,18,15,22,38,44,44,37,1
21.09.2025,2025,fra,158,Le Portel,JL Bourg,65,94,15,27,19,21,10,26,21,20,42,40,36,41,-1
20.09.2025,2025,fra,151,Saint Quentin,Monaco,68,66,17,14,21,15,20,15,10,22,31,36,35,32,-1
22.09.2025,2025,fra b,157,Chartres,Nantes,66,88,20,25,22,26,11,15,13,22,45,48,26,35,-1
21.09.2025,2025,fra b,157,Chalons-Reims,Roanne,81,91,19,22,21,21,22,24,19,24,41,42,46,43,1
22.09.2025,2025,ger,169,Hamburg,Alba Berlin,97,80,21,15,27,29,22,25,27,11,36,56,47,38,1
22.09.2025,2025,ger,159,Ludwigsburg,Bayern,78,70,25,16,17,19,17,19,19,16,41,36,36,35,-1
22.09.2025,2025,ger,166,Chemnitz,Ulm,86,90,18,24,20,23,21,22,27,21,42,43,43,48,1
22.09.2025,2025,ger,160,Syntainics MBC,Rostock,84,87,19,20,20,22,15,16,22,18,39,42,31,40,-1
22.09.2025,2025,ger,162,Bamberg,Basketball Braunschweig,77,96,18,16,19,19,19,36,21,25,34,38,55,46,1
21.09.2025,2025,ger,160,Gottingen,Frankfurt,72,100,12,29,18,26,33,19,9,26,41,44,52,35,1
21.09.2025,2025,ger,173,Oldenburg,Heidelberg,105,82,27,22,29,20,25,20,24,20,49,49,45,44,1
20.09.2025,2025,ger,167,Bayern,Chemnitz,73,59,16,16,20,12,26,18,11,13,32,32,44,24,-1
22.09.2025,2025,ger b,168,Bremerhaven,Vechta 2,111,64,28,16,29,12,25,18,29,18,44,41,43,47,1
22.09.2025,2025,ger b,164,Nurnberger,Artland,71,74,20,21,19,15,11,15,21,23,41,34,26,44,-1
21.09.2025,2025,ger b,159,Munster,PS Karlsruhe,84,73,22,14,23,16,19,18,20,25,36,39,37,45,1
21.09.2025,2025,ger b,170,Bayreuth,Crailsheim Merlins,103,106,25,20,28,29,29,32,21,25,45,57,61,46,1
21.09.2025,2025,ger b,164,Kirchheim,Giessen,92,73,25,17,26,16,20,26,21,14,42,42,46,35,-1
21.09.2025,2025,ger b,162,Phoenix Hagen,Jena,76,84,19,24,24,11,16,24,17,25,43,35,40,42,1
21.09.2025,2025,ger b,162,Dresden,Dusseldorf,84,74,24,17,19,15,25,21,16,21,41,34,46,37,1
20.09.2025,2025,ger b,163,Koblenz,Bochum,64,81,17,12,20,29,5,22,22,18,29,49,27,40,-1
20.09.2025,2025,ger b,161,Trier,Tubingen,69,77,14,22,22,23,15,18,18,14,36,45,33,32,-1
22.09.2025,2025,kos,,Bashkimi,Vellaznimi,72,51,18,15,15,3,21,7,18,26,33,18,28,44,
21.09.2025,2025,kos,,Sigal Prishtina,Bora,96,82,23,19,23,15,26,25,24,23,42,38,51,47,
15.09.2025,2025,kos,,Prizreni,Sigal Prishtina,100,88,29,17,27,20,24,19,20,32,46,47,43,52,
15.09.2025,2025,kos,,Bora,Golden Eagle Ylli,67,74,27,13,14,28,12,13,14,20,40,42,25,34,
14.09.2025,2025,kos,,Vellaznimi,Peja,73,65,13,17,31,20,15,13,14,15,30,51,28,29,
22.09.2025,2025,lat lkl,169,BC Wolves,Jonava,103,90,25,21,27,20,21,22,30,27,46,47,43,57,1
22.09.2025,2025,lat lkl,161,Siauliai,Zalgiris Kaunas,63,91,19,17,15,23,16,28,13,23,36,38,44,36,-1
21.09.2025,2025,lat lkl,174,Rytas,Neptunas,84,90,12,19,21,17,24,22,27,32,31,38,46,59,1
21.09.2025,2025,lat lkl,158,Lietkabelis,Mazeikiai,82,78,24,17,19,17,19,20,20,24,41,36,39,44,1
22.09.2025,2025,vtb,151,Saratov,Parma Perm,67,59,21,13,18,12,10,19,18,15,34,30,29,33,-1
22.09.2025,2025,vtb,153,Samara,Uralmash Ekaterinburg,79,92,21,22,23,27,18,25,17,18,43,50,43,35,1
22.09.2025,2025,vtb,165,Lokomotiv Kuban,Enisey,88,65,20,13,26,20,23,13,19,19,33,46,36,38,-1
22.09.2025,2025,vtb,153,Astana,Nizhny Novgorod,62,90,12,22,21,31,11,19,18,18,34,52,30,36,-1
21.09.2025,2025,vtb,154,Zenit Petersburg,MBA Moscow,103,75,22,18,25,23,33,13,23,21,40,48,46,44,1
21.09.2025,2025,vtb,162,CSKA Moscow,Unics Kazan,71,55,10,19,11,9,27,13,23,14,29,20,40,37,-1
22.09.2025,2025,,,AIK Basket,KFUM Fryshuset,66,97,20,26,10,19,14,28,22,24,46,29,42,46,
22.09.2025,2025,,,Huddinge,Wetterbygden Stars,72,75,14,26,19,12,19,20,20,17,40,31,39,37,
22.09.2025,2025,,,Ockelbo,Malbas,79,71,26,20,22,13,21,15,10,23,46,35,36,33,
21.09.2025,2025,,,Akersberga,Wetterbygden Stars,77,79,20,18,29,24,15,16,13,21,38,53,31,34,
21.09.2025,2025,,,Aros Basket,Malbas,66,70,18,16,17,14,21,20,10,20,34,31,41,30,
21.09.2025,2025,,,Tureberg,Djurgarden,47,80,12,10,17,24,6,20,12,26,22,41,26,38,
21.09.2025,2025,,,Alvik,Blackeberg,91,82,21,23,25,26,22,19,23,14,44,51,41,37,
23.09.2025,2025,tur b,152,Bordo Sportif,Balikesir,72,60,26,16,17,20,18,12,11,12,42,37,30,23,-1
22.09.2025,2025,tur b,,Istanbul Anka Spor,OGM Ormanspor,72,84,26,22,14,16,16,24,16,22,48,30,40,38,
22.09.2025,2025,tur b,154,Trabzonspor,Harem Spor,80,85,8,25,27,15,24,20,21,25,33,42,44,46,1
22.09.2025,2025,tur b,147,Konya BBSK,Çağdaş Bodrum Spor,93,84,27,20,26,14,21,20,19,30,47,40,41,49,1
21.09.2025,2025,tur b,159,MKE Ankaragucu,Kapakli Spor,95,79,24,17,21,17,31,22,19,23,41,38,53,42,1
21.09.2025,2025,tur b,151,iLab Basketbol,CO Basket,84,71,27,16,19,20,23,18,15,17,43,39,41,32,-1
21.09.2025,2025,tur b,155,Final Spor,Fenerbahce 2,86,91,28,20,14,24,24,20,20,27,48,38,44,47,1
21.09.2025,2025,tur b,156,Ankara Kolejliler,Gaziantep,85,89,13,23,20,14,17,26,28,15,36,34,43,43,1
20.09.2025,2025,tur b,158,Esenler Erokspor,Cayirova,88,81,16,23,22,24,24,25,26,9,39,46,49,35,1
23.09.2025,2025,rom,158,CSU Sibiu,Corona Brasov,77,68,31,13,18,12,10,16,18,27,44,30,26,45,-1
21.09.2025,2025,rom,163,Dinamo Bucharest,CSM Targu Mures,87,84,27,21,23,22,15,26,22,15,48,45,41,37,-1
21.09.2025,2025,rom,150,SCM Craiova,Rapid Bucuresti,67,72,22,21,14,24,16,12,15,15,43,38,28,30,-1
21.09.2025,2025,rom,153,BC Timisoara,Arges Pitesti,72,81,12,19,19,20,22,19,19,23,31,39,41,42,1
20.09.2025,2025,rom,172,CSM Constanta,Municipal Galati,99,88,24,25,31,17,12,18,32,28,49,48,30,60,1
20.09.2025,2025,rom,161,Voluntari,Valcea,92,90,19,29,29,20,20,19,24,22,48,49,39,46,1
23.09.2025,2025,friendly,159,LG Sakers (Kor),x,84,88,24,18,21,20,22,22,17,28,42,41,44,45,1
23.09.2025,2025,friendly,,Obera TC (Arg),x,72,107,17,27,22,27,9,29,24,24,44,49,38,48,
22.09.2025,2025,friendly,156,Olympiacos (Gre),x,90,95,25,24,23,27,22,22,20,22,49,50,44,42,1
22.09.2025,2025,friendly,156,Peristeri (Gre),x,75,87,23,10,21,21,13,27,18,29,33,42,40,47,1
22.09.2025,2025,friendly,157,Oliveirense (Por),x,84,71,20,22,22,19,13,14,29,16,42,41,27,45,-1
22.09.2025,2025,friendly,162,Sagesse Beirut (Leb),x,55,89,17,25,12,17,15,27,11,20,42,29,42,31,-1
22.09.2025,2025,friendly,171,Sichuan (Chn),x,90,73,31,12,22,22,17,16,20,23,43,44,33,43,-1
22.09.2025,2025,friendly,157,Liaoning (Chn),x,69,67,16,20,13,13,16,20,24,14,36,26,36,38,-1
22.09.2025,2025,friendly,167,Fujian (Chn),x,85,83,27,25,14,26,15,19,29,13,52,40,34,42,-1
22.09.2025,2025,friendly,152,Beijing Royal Fighters (Chn),x,104,72,32,16,34,11,28,27,10,18,48,45,55,28,1
22.09.2025,2025,friendly,156,Shandong (Chn),x,76,86,18,20,21,20,22,19,15,27,38,41,41,42,1
22.09.2025,2025,friendly,166,Al Bashaer (Oma),x,82,56,21,18,17,9,16,10,28,19,39,26,26,47,-1
22.09.2025,2025,friendly,164,Tianjin (Chn),x,67,89,22,18,15,26,11,24,19,21,40,41,35,40,-1
22.09.2025,2025,friendly,155,Shenzhen (Chn),x,76,96,18,33,16,27,18,23,24,13,51,43,41,37,1
22.09.2025,2025,friendly,174,Qingdao (Chn),x,97,72,25,17,21,22,24,16,27,17,42,43,40,44,-1
22.09.2025,2025,friendly,147,Jilin (Chn),x,68,85,12,12,18,20,19,27,19,26,24,38,46,45,1
22.09.2025,2025,friendly,151,Shanghai (Chn),x,72,83,18,20,22,17,15,21,17,25,38,39,36,42,1
22.09.2025,2025,friendly,159,Riachuelo (Arg),x,82,77,19,19,20,16,19,21,24,21,38,36,40,45,1
22.09.2025,2025,avst,183,Sydney,x,94,102,28,27,20,24,27,19,19,32,55,44,46,51,1
21.09.2025,2025,avst,180,Illawarra Hawks,x,75,102,21,26,24,28,15,18,15,30,47,52,33,45,-1
21.09.2025,2025,avst,176,Brisbane Bullets,x,91,87,24,19,27,15,21,18,19,35,43,42,39,54,1
20.09.2025,2025,avst,189,South East Melbourne,x,106,98,29,17,24,27,27,21,26,33,46,51,48,59,1
19.09.2025,2025,avst,173,Tasmania JackJumpers,x,88,79,23,20,22,23,27,16,16,20,43,45,43,36,-1
22.09.2025,2025,cek,166,Brno,x,95,74,29,23,28,13,16,22,22,16,52,41,38,38,-1
21.09.2025,2025,cek,163,NH Ostrava,x,103,94,25,25,29,28,22,18,27,23,50,57,40,50,1
21.09.2025,2025,cek,161,Pardubice,x,93,88,27,19,22,23,22,21,22,25,46,45,43,47,1
21.09.2025,2025,cek,156,Jindrichuv Hradec,x,98,86,30,22,19,19,19,20,30,25,52,38,39,55,1
22.09.2025,2025,fiba,162,Sassari,x,78,71,20,21,12,12,32,15,14,23,41,24,47,37,1
22.09.2025,2025,fiba,156,BC Kalev/Cramo,x,80,66,11,21,23,22,26,10,20,13,32,45,36,33,-1
21.09.2025,2025,fiba,160,Petkim Spor,x,69,79,22,12,8,17,23,21,16,29,34,25,44,45,1
21.09.2025,2025,fiba,156,Fribourg Olympic,x,91,85,28,26,24,15,14,25,25,19,54,39,39,44,1
20.09.2025,2025,fiba,158,Juventus,x,77,73,23,14,17,18,19,16,18,25,37,35,35,43,-1
22.09.2025,2025,aba,167,Cedevita Olimpija,x,75,62,21,20,12,20,26,8,16,14,41,32,34,30,-1
22.09.2025,2025,aba,164,Mega Basket,x,70,80,19,16,14,23,16,18,21,23,35,37,34,44,-1
22.09.2025,2025,aba,163,Crvena zvezda,x,86,84,28,16,22,25,16,22,20,21,44,47,38,41,-1
21.09.2025,2025,aba,163,Buducnost,x,51,98,20,24,8,26,10,25,13,23,44,34,35,36,-1
21.09.2025,2025,aba,156,Igokea,x,74,79,14,14,18,21,31,24,11,20,28,39,55,31,1
20.09.2025,2025,aba,157,Zadar,x,69,87,17,27,23,15,10,23,19,22,44,38,33,41,-1
22.09.2025,2025,bnxt,156,Oostende,x,61,102,19,29,17,29,11,25,14,19,48,46,36,33,-1
22.09.2025,2025,bnxt,152,Okapi Aalst,x,90,82,22,17,18,25,21,16,29,24,39,43,37,53,1
21.09.2025,2025,bnxt,150,Leiden,x,79,80,18,13,20,8,7,24,16,16,31,28,31,32,-1
21.09.2025,2025,bnxt,153,Belfius Mons,x,79,92,11,24,28,27,18,19,22,22,35,55,37,44,1
20.09.2025,2025,bnxt,155,BAL Weert,x,115,75,30,16,28,22,31,22,26,15,46,50,53,41,1
20.09.2025,2025,bnxt,154,Mechelen,x,74,65,20,20,19,10,23,20,12,15,40,29,43,27,-1
20.09.2025,2025,bnxt,154,Feyenoord,x,106,60,30,13,19,15,29,14,28,18,43,34,43,46,1
18.09.2025,2025,bnxt,152,Oostende,x,72,82,19,24,12,18,14,23,27,17,43,30,37,44,1
22.09.2025,2025,fra,160,Nanterre,x,90,87,18,26,21,19,22,18,29,24,44,40,40,53,1
22.09.2025,2025,fra,154,Paris,x,89,85,24,22,20,24,25,23,20,16,46,44,48,36,1
22.09.2025,2025,fra,156,Le Mans,x,85,71,18,23,25,14,25,19,17,15,41,39,44,32,-1
21.09.2025,2025,fra,152,La Rochelle,x,64,56,16,18,17,10,14,18,17,10,34,27,32,27,-1
21.09.2025,2025,fra,160,Chalon/Saone,x,83,80,21,17,21,23,26,18,15,22,38,44,44,37,1
21.09.2025,2025,fra,158,JL Bourg,x,65,94,15,27,19,21,10,26,21,20,42,40,36,41,-1
20.09.2025,2025,fra,151,Monaco,x,68,66,17,14,21,15,20,15,10,22,31,36,35,32,-1
22.09.2025,2025,fra b,157,Nantes,x,66,88,20,25,22,26,11,15,13,22,45,48,26,35,-1
21.09.2025,2025,fra b,157,Roanne,x,81,91,19,22,21,21,22,24,19,24,41,42,46,43,1
22.09.2025,2025,ger,169,Alba Berlin,x,97,80,21,15,27,29,22,25,27,11,36,56,47,38,1
22.09.2025,2025,ger,159,Bayern,x,78,70,25,16,17,19,17,19,19,16,41,36,36,35,-1
22.09.2025,2025,ger,166,Ulm,x,86,90,18,24,20,23,21,22,27,21,42,43,43,48,1
22.09.2025,2025,ger,160,Rostock,x,84,87,19,20,20,22,15,16,22,18,39,42,31,40,-1
22.09.2025,2025,ger,162,Basketball Braunschweig,x,77,96,18,16,19,19,19,36,21,25,34,38,55,46,1
21.09.2025,2025,ger,160,Frankfurt,x,72,100,12,29,18,26,33,19,9,26,41,44,52,35,1
21.09.2025,2025,ger,173,Heidelberg,x,105,82,27,22,29,20,25,20,24,20,49,49,45,44,1
20.09.2025,2025,ger,167,Chemnitz,x,73,59,16,16,20,12,26,18,11,13,32,32,44,24,-1
22.09.2025,2025,ger b,168,Vechta 2,x,111,64,28,16,29,12,25,18,29,18,44,41,43,47,1
22.09.2025,2025,ger b,164,Artland,x,71,74,20,21,19,15,11,15,21,23,41,34,26,44,-1
21.09.2025,2025,ger b,159,PS Karlsruhe,x,84,73,22,14,23,16,19,18,20,25,36,39,37,45,1
21.09.2025,2025,ger b,170,Crailsheim Merlins,x,103,106,25,20,28,29,29,32,21,25,45,57,61,46,1
21.09.2025,2025,ger b,164,Giessen,x,92,73,25,17,26,16,20,26,21,14,42,42,46,35,-1
21.09.2025,2025,ger b,162,Jena,x,76,84,19,24,24,11,16,24,17,25,43,35,40,42,1
21.09.2025,2025,ger b,162,Dusseldorf,x,84,74,24,17,19,15,25,21,16,21,41,34,46,37,1
20.09.2025,2025,ger b,163,Bochum,x,64,81,17,12,20,29,5,22,22,18,29,49,27,40,-1
20.09.2025,2025,ger b,161,Tubingen,x,69,77,14,22,22,23,15,18,18,14,36,45,33,32,-1
22.09.2025,2025,kos,,Vellaznimi,x,72,51,18,15,15,3,21,7,18,26,33,18,28,44,
21.09.2025,2025,kos,,Bora,x,96,82,23,19,23,15,26,25,24,23,42,38,51,47,
15.09.2025,2025,kos,,Sigal Prishtina,x,100,88,29,17,27,20,24,19,20,32,46,47,43,52,
15.09.2025,2025,kos,,Golden Eagle Ylli,x,67,74,27,13,14,28,12,13,14,20,40,42,25,34,
14.09.2025,2025,kos,,Peja,x,73,65,13,17,31,20,15,13,14,15,30,51,28,29,
22.09.2025,2025,lat lkl,169,Jonava,x,103,90,25,21,27,20,21,22,30,27,46,47,43,57,1
22.09.2025,2025,lat lkl,161,Zalgiris Kaunas,x,63,91,19,17,15,23,16,28,13,23,36,38,44,36,-1
21.09.2025,2025,lat lkl,174,Neptunas,x,84,90,12,19,21,17,24,22,27,32,31,38,46,59,1
21.09.2025,2025,lat lkl,158,Mazeikiai,x,82,78,24,17,19,17,19,20,20,24,41,36,39,44,1
22.09.2025,2025,vtb,151,Parma Perm,x,67,59,21,13,18,12,10,19,18,15,34,30,29,33,-1
22.09.2025,2025,vtb,153,Uralmash Ekaterinburg,x,79,92,21,22,23,27,18,25,17,18,43,50,43,35,1
22.09.2025,2025,vtb,165,Enisey,x,88,65,20,13,26,20,23,13,19,19,33,46,36,38,-1
22.09.2025,2025,vtb,153,Nizhny Novgorod,x,62,90,12,22,21,31,11,19,18,18,34,52,30,36,-1
21.09.2025,2025,vtb,154,MBA Moscow,x,103,75,22,18,25,23,33,13,23,21,40,48,46,44,1
21.09.2025,2025,vtb,162,Unics Kazan,x,71,55,10,19,11,9,27,13,23,14,29,20,40,37,-1
22.09.2025,2025,,,KFUM Fryshuset,x,66,97,20,26,10,19,14,28,22,24,46,29,42,46,
22.09.2025,2025,,,Wetterbygden Stars,x,72,75,14,26,19,12,19,20,20,17,40,31,39,37,
22.09.2025,2025,,,Malbas,x,79,71,26,20,22,13,21,15,10,23,46,35,36,33,
21.09.2025,2025,,,Wetterbygden Stars,x,77,79,20,18,29,24,15,16,13,21,38,53,31,34,
21.09.2025,2025,,,Malbas,x,66,70,18,16,17,14,21,20,10,20,34,31,41,30,
21.09.2025,2025,,,Djurgarden,x,47,80,12,10,17,24,6,20,12,26,22,41,26,38,
21.09.2025,2025,,,Blackeberg,x,91,82,21,23,25,26,22,19,23,14,44,51,41,37,
23.09.2025,2025,tur b,152,Balikesir,x,72,60,26,16,17,20,18,12,11,12,42,37,30,23,-1
22.09.2025,2025,tur b,,OGM Ormanspor,x,72,84,26,22,14,16,16,24,16,22,48,30,40,38,
22.09.2025,2025,tur b,154,Harem Spor,x,80,85,8,25,27,15,24,20,21,25,33,42,44,46,1
22.09.2025,2025,tur b,147,Çağdaş Bodrum Spor,x,93,84,27,20,26,14,21,20,19,30,47,40,41,49,1
21.09.2025,2025,tur b,159,Kapakli Spor,x,95,79,24,17,21,17,31,22,19,23,41,38,53,42,1
21.09.2025,2025,tur b,151,CO Basket,x,84,71,27,16,19,20,23,18,15,17,43,39,41,32,-1
21.09.2025,2025,tur b,155,Fenerbahce 2,x,86,91,28,20,14,24,24,20,20,27,48,38,44,47,1
21.09.2025,2025,tur b,156,Gaziantep,x,85,89,13,23,20,14,17,26,28,15,36,34,43,43,1
20.09.2025,2025,tur b,158,Cayirova,x,88,81,16,23,22,24,24,25,26,9,39,46,49,35,1
23.09.2025,2025,rom,158,Corona Brasov,x,77,68,31,13,18,12,10,16,18,27,44,30,26,45,-1
21.09.2025,2025,rom,163,CSM Targu Mures,x,87,84,27,21,23,22,15,26,22,15,48,45,41,37,-1
21.09.2025,2025,rom,150,Rapid Bucuresti,x,67,72,22,21,14,24,16,12,15,15,43,38,28,30,-1
21.09.2025,2025,rom,153,Arges Pitesti,x,72,81,12,19,19,20,22,19,19,23,31,39,41,42,1
20.09.2025,2025,rom,172,Municipal Galati,x,99,88,24,25,31,17,12,18,32,28,49,48,30,60,1
20.09.2025,2025,rom,161,Valcea,x,92,90,19,29,29,20,20,19,24,22,48,49,39,46,1
25.09.2025,2025,cek,162,Brno,Slavia Prague,67,63,21,16,12,16,17,15,17,16,37,28,32,33,-1
25.09.2025,2025,cek,165,Jindrichuv Hradec,Usti n. Labem,85,86,16,20,25,22,27,15,17,29,36,47,42,46,1
25.09.2025,2025,cek,171,NH Ostrava,Srsni Pisek,88,97,17,18,18,26,30,29,23,24,35,44,59,47,1
25.09.2025,2025,cek,167,Nymburk,Olomoucko,107,73,21,20,34,25,25,15,27,13,41,59,40,40,-1
25.09.2025,2025,cek,163,USK Prague,Decin,65,71,21,17,11,13,17,19,16,22,38,24,36,38,-1
25.09.2025,2025,cek,163,Pardubice,Opava,76,83,19,17,22,29,14,18,21,19,36,51,32,40,-1
25.09.2025,2025,eurocup,154,Venezia,Aris,95,75,30,22,17,19,22,16,26,18,52,36,38,44,1
25.09.2025,2025,eurocup,160,Besiktas,Buducnost,94,76,25,19,24,20,18,12,27,25,44,44,30,52,1
25.09.2025,2025,eurocup,170,Hapoel Jerusalem,Valencia,64,80,14,26,15,19,15,14,20,21,40,34,29,41,-1
25.09.2025,2025,eurocup,163,Trefl Sopot,Ulm,93,96,32,23,9,15,21,17,19,26,55,24,38,45,1
25.09.2025,2025,eurocup,169,BC Wolves,Bahcesehir Kol.,69,80,26,23,17,22,13,20,13,15,49,39,33,28,-1
25.09.2025,2025,eurocup,167,Cluj-Napoca,Cedevita Olimpija,86,93,24,19,14,27,28,25,20,22,43,41,53,42,1
24.09.2025,2025,eurocup,163,Gran Canaria,Trento,84,81,23,22,22,27,15,7,24,25,45,49,22,49,-1
24.09.2025,2025,eurocup,170,Joventut Badalona,Hapoel Tel-Aviv,78,75,16,21,21,16,20,18,21,20,37,37,38,41,-1
24.09.2025,2025,eurocup,167,Hamburg,JL Bourg,80,100,16,35,24,29,21,18,19,18,51,53,39,37,-1
24.09.2025,2025,eurocup,159,Turk Telekom,Lietkabelis,72,66,22,17,13,17,19,14,18,18,39,30,33,36,-1
25.09.2025,2025,aba,164,Partizan,Borac,96,66,24,19,22,17,31,12,19,18,43,39,43,37,-1
25.09.2025,2025,aba,154,Zadar,Igokea,76,79,14,26,16,17,16,10,19,12,40,33,26,31,-1
25.09.2025,2025,aba 2,152,Vojvodina Novi Sad,KK Bosna,77,68,19,17,18,25,21,10,19,16,36,43,31,35,-1
25.09.2025,2025,aba 2,159,Cedevita Junior,Helios Domzale,79,87,16,21,25,18,14,21,24,27,37,43,35,51,1
24.09.2025,2025,aba 2,149,MZT Skopje,Tivat,68,50,21,13,14,11,15,15,18,11,34,25,30,29,-1
26.09.2025,2025,vtb,156,MBA Moscow,Enisey,58,72,10,19,18,15,15,19,15,19,29,33,34,34,-1
26.09.2025,2025,vtb,153,Unics Kazan,Samara,86,70,19,12,18,15,25,21,24,22,31,33,46,46,1
25.09.2025,2025,vtb,163,CSKA Moscow,Uralmash Ekaterinburg,98,56,21,18,32,8,22,9,23,21,39,40,31,44,-1
25.09.2025,2025,vtb,161,Lokomotiv Kuban,Astana,127,84,30,22,28,25,34,23,35,14,52,53,57,49,1
25.09.2025,2025,vtb,155,Zenit Petersburg,Saratov,103,86,26,24,23,23,25,21,29,18,50,46,46,47,1
25.09.2025,2025,vtb,143,Nizhny Novgorod,Parma Perm,83,51,21,11,18,10,27,13,17,17,32,28,40,34,1
25.09.2025,2025,cek,162,Slavia Prague,x,67,63,21,16,12,16,17,15,17,16,37,28,32,33,-1
25.09.2025,2025,cek,165,Usti n. Labem,x,85,86,16,20,25,22,27,15,17,29,36,47,42,46,1
25.09.2025,2025,cek,171,Srsni Pisek,x,88,97,17,18,18,26,30,29,23,24,35,44,59,47,1
25.09.2025,2025,cek,167,Olomoucko,x,107,73,21,20,34,25,25,15,27,13,41,59,40,40,-1
25.09.2025,2025,cek,163,Decin,x,65,71,21,17,11,13,17,19,16,22,38,24,36,38,-1
25.09.2025,2025,cek,163,Opava,x,76,83,19,17,22,29,14,18,21,19,36,51,32,40,-1
25.09.2025,2025,eurocup,154,Aris,x,95,75,30,22,17,19,22,16,26,18,52,36,38,44,1
25.09.2025,2025,eurocup,160,Buducnost,x,94,76,25,19,24,20,18,12,27,25,44,44,30,52,1
25.09.2025,2025,eurocup,170,Valencia,x,64,80,14,26,15,19,15,14,20,21,40,34,29,41,-1
25.09.2025,2025,eurocup,163,Ulm,x,93,96,32,23,9,15,21,17,19,26,55,24,38,45,1
25.09.2025,2025,eurocup,169,Bahcesehir Kol.,x,69,80,26,23,17,22,13,20,13,15,49,39,33,28,-1
25.09.2025,2025,eurocup,167,Cedevita Olimpija,x,86,93,24,19,14,27,28,25,20,22,43,41,53,42,1
24.09.2025,2025,eurocup,163,Trento,x,84,81,23,22,22,27,15,7,24,25,45,49,22,49,-1
24.09.2025,2025,eurocup,170,Hapoel Tel-Aviv,x,78,75,16,21,21,16,20,18,21,20,37,37,38,41,-1
24.09.2025,2025,eurocup,167,JL Bourg,x,80,100,16,35,24,29,21,18,19,18,51,53,39,37,-1
24.09.2025,2025,eurocup,159,Lietkabelis,x,72,66,22,17,13,17,19,14,18,18,39,30,33,36,-1
25.09.2025,2025,aba,164,Borac,x,96,66,24,19,22,17,31,12,19,18,43,39,43,37,-1
25.09.2025,2025,aba,154,Igokea,x,76,79,14,26,16,17,16,10,19,12,40,33,26,31,-1
25.09.2025,2025,aba 2,152,KK Bosna,x,77,68,19,17,18,25,21,10,19,16,36,43,31,35,-1
25.09.2025,2025,aba 2,159,Helios Domzale,x,79,87,16,21,25,18,14,21,24,27,37,43,35,51,1
24.09.2025,2025,aba 2,149,Tivat,x,68,50,21,13,14,11,15,15,18,11,34,25,30,29,-1
26.09.2025,2025,vtb,156,Enisey,x,58,72,10,19,18,15,15,19,15,19,29,33,34,34,-1
26.09.2025,2025,vtb,153,Samara,x,86,70,19,12,18,15,25,21,24,22,31,33,46,46,1
25.09.2025,2025,vtb,163,Uralmash Ekaterinburg,x,98,56,21,18,32,8,22,9,23,21,39,40,31,44,-1
25.09.2025,2025,vtb,161,Astana,x,127,84,30,22,28,25,34,23,35,14,52,53,57,49,1
25.09.2025,2025,vtb,155,Saratov,x,103,86,26,24,23,23,25,21,29,18,50,46,46,47,1
25.09.2025,2025,vtb,143,Parma Perm,x,83,51,21,11,18,10,27,13,17,17,32,28,40,34,1
28.09.2025,2025,slovak,164,Iskra Svit,BKM Lucenec,90,88,30,28,21,20,25,18,14,22,58,41,43,36,-1
28.09.2025,2025,slovak,155,MBK Handlova,BC Komarno,107,76,24,19,38,16,19,22,26,19,43,54,41,45,1
28.09.2025,2025,slovak,163,Spisski Rytieri,Nitra Blue Wings,90,84,14,26,25,21,32,19,19,18,40,46,51,37,1
28.09.2025,2025,slovak,160,Inter Bratislava,SPU Nitra,110,75,23,21,29,21,26,16,32,17,44,50,42,49,1
25.09.2025,2025,slovak,161,Nitra Blue Wings,Inter Bratislava,73,76,18,13,17,21,18,15,20,27,31,38,33,47,-1
25.09.2025,2025,slovak,163,BC Komarno,Levice,61,84,15,24,22,17,9,18,15,25,39,39,27,40,-1
25.09.2025,2025,slovak,160,BKM Lucenec,MBK Handlova,53,78,9,17,11,15,14,22,19,24,26,26,36,43,-1
25.09.2025,2025,slovak,159,SPU Nitra,Iskra Svit,84,91,22,28,20,28,24,17,18,18,50,48,41,36,-1
21.09.2025,2025,slovak,154,Inter Bratislava,BC Prievidza,99,85,21,19,19,18,29,22,30,26,40,37,51,56,1
21.09.2025,2025,slovak,163,MBK Handlova,Iskra Svit,67,54,16,16,13,12,19,12,19,14,32,25,31,33,-1
21.09.2025,2025,slovak,150,Nitra Blue Wings,SPU Nitra,94,70,29,11,25,23,27,24,13,12,40,48,51,25,1
21.09.2025,2025,slovak,162,Spisski Rytieri,BC Komarno,100,87,31,20,19,19,29,28,21,20,51,38,57,41,1
29.09.2025,2025,avst,183,New Zealand Breakers,South East Melbourne,81,79,11,21,22,15,27,23,21,20,32,37,50,41,-1
29.09.2025,2025,avst,192,Sydney,Illawarra Hawks,89,96,15,27,32,21,20,27,22,21,42,53,47,43,-1
28.09.2025,2025,avst,173,Tasmania JackJumpers,Melbourne United,81,72,20,14,24,19,17,16,20,23,34,43,33,43,-1
28.09.2025,2025,avst,176,Cairns Taipans,Adelaide,101,97,28,32,30,22,19,23,24,20,60,52,42,44,-1
27.09.2025,2025,avst,190,Perth,Sydney,87,88,11,27,29,16,18,24,29,21,38,45,42,50,-1
27.09.2025,2025,avst,183,Illawarra Hawks,Brisbane Bullets,113,101,38,25,21,35,30,20,24,21,63,56,50,45,1
26.09.2025,2025,avst,188,South East Melbourne,Melbourne United,84,96,28,21,12,25,20,21,24,29,49,37,41,53,-1
29.09.2025,2025,cek,158,Usti n. Labem,Pardubice,88,81,23,30,23,20,18,23,24,8,53,43,41,32,-1
29.09.2025,2025,cek,166,Srsni Pisek,USK Prague,99,89,26,24,27,30,20,19,26,16,50,57,39,42,-1
28.09.2025,2025,cek,169,Decin,Jindrichuv Hradec,95,73,25,18,23,15,18,15,29,25,43,38,33,54,1
28.09.2025,2025,cek,167,Olomoucko,Brno,67,78,13,27,19,12,23,18,12,21,40,31,41,33,-1
28.09.2025,2025,cek,161,Slavia Prague,NH Ostrava,89,87,23,25,24,22,20,18,22,22,48,46,38,44,1
28.09.2025,2025,cek,166,Opava,Nymburk,75,94,14,19,20,25,14,21,27,29,33,45,35,56,1
29.09.2025,2025,aba,164,Subotica,Partizan,80,89,25,24,19,17,15,18,21,30,49,36,33,51,1
29.09.2025,2025,aba,165,Cedevita Olimpija,Dubai,84,92,17,29,25,34,18,20,24,9,46,59,38,33,-1
29.09.2025,2025,aba,164,Mega Basket,FMP Beograd,83,80,17,24,21,21,19,17,26,18,41,42,36,44,-1
28.09.2025,2025,aba,159,Buducnost,Split,97,75,33,13,26,27,19,14,19,21,46,53,33,40,-1
28.09.2025,2025,aba,166,Crvena zvezda,Mornar Bar,91,72,22,14,23,27,22,17,24,14,36,50,39,38,-1
26.09.2025,2025,aba,161,Studentski Centar,Subotica,84,76,20,24,34,22,13,14,17,16,44,56,27,33,-1
29.09.2025,2025,bnxt,154,Zwolle,Circus Brussels,84,81,22,26,23,24,17,16,22,15,48,47,33,37,-1
28.09.2025,2025,bnxt,156,Belfius Mons,Okapi Aalst,76,69,11,14,20,15,21,22,13,14,25,35,43,27,-1
28.09.2025,2025,bnxt,155,Oostende,Mechelen,75,79,16,22,19,19,26,12,14,26,38,38,38,40,1
28.09.2025,2025,bnxt,154,Antwerp Giants,Yoast Utd,82,76,19,21,24,19,10,27,29,9,40,43,37,38,-1
28.09.2025,2025,bnxt,157,Den Bosch,LWD Basket,97,99,28,22,19,22,18,16,17,22,50,41,34,39,-1
28.09.2025,2025,bnxt,146,Leiden,Leuven Bears,78,77,13,19,29,16,16,18,20,24,32,45,34,44,1
28.09.2025,2025,bnxt,162,Donar Groningen,Kortrijk,70,99,26,22,9,27,16,25,19,25,48,36,41,44,1
27.09.2025,2025,bnxt,152,Limburg,Den Helder,84,44,15,11,22,8,25,7,22,18,26,30,32,40,-1
25.09.2025,2025,bnxt,155,Circus Brussels,Antwerp Giants,67,65,19,14,20,21,13,13,15,17,33,41,26,32,-1
29.09.2025,2025,fra,158,JL Bourg,Lyon-Villeurbanne,85,94,21,32,24,17,19,23,21,22,53,41,42,43,1
29.09.2025,2025,fra,153,Gravelines-Dunkerque,Limoges,70,56,23,9,14,13,22,9,11,25,32,27,31,36,-1
29.09.2025,2025,fra,157,Monaco,Strasbourg,77,65,19,24,16,16,20,12,22,13,43,32,32,35,-1
28.09.2025,2025,fra,165,Chalon/Saone,Paris,87,102,23,27,17,26,27,27,20,22,50,43,54,42,1
28.09.2025,2025,fra,150,Le Mans,Saint Quentin,69,83,18,24,17,25,21,16,13,18,42,42,37,31,-1
28.09.2025,2025,fra,164,Nanterre,Le Portel,74,65,19,19,24,21,16,12,15,13,38,45,28,28,-1
27.09.2025,2025,fra,149,La Rochelle,Cholet,64,78,9,17,18,20,20,24,17,17,26,38,44,34,1
28.09.2025,2025,fra b,164,Ada Blois,Aix Maurienne,97,82,21,19,34,16,17,24,25,23,40,50,41,48,1
27.09.2025,2025,fra b,152,Pau-Orthez,Antibes,92,87,25,21,23,19,15,22,29,25,46,42,37,54,1
27.09.2025,2025,fra b,154,Chalons-Reims,Orleans,83,90,17,20,15,15,21,23,21,16,37,30,44,37,1
27.09.2025,2025,fra b,157,Hyeres-Toulon,Poitiers,79,87,25,18,14,20,9,21,31,28,43,34,30,59,1
27.09.2025,2025,fra b,167,Vichy,St. Chamond,86,79,22,22,17,12,25,19,22,26,44,29,44,48,1
27.09.2025,2025,fra b,148,Boulazac,Nantes,81,75,20,13,17,22,23,17,21,23,33,39,40,44,1
27.09.2025,2025,fra b,157,Chartres,Fos-sur-Mer,69,75,16,14,21,19,15,20,17,22,30,40,35,39,-1
27.09.2025,2025,fra b,157,Evreux,ASA,80,79,24,25,19,20,12,19,25,15,49,39,31,40,-1
27.09.2025,2025,fra b,160,Roanne,Caen,79,65,19,16,15,19,20,12,25,18,35,34,32,43,-1
27.09.2025,2025,fra b,157,Rouen,Denain-Voltaire,76,92,18,19,17,14,22,27,19,32,37,31,49,51,1
29.09.2025,2025,ger,163,Frankfurt,Bamberg,58,66,15,19,15,13,13,18,15,16,34,28,31,31,-1
29.09.2025,2025,ger,163,Bayern,Hamburg,81,80,21,21,21,20,16,19,23,20,42,41,35,43,-1
29.09.2025,2025,ger,173,Heidelberg,Vechta,80,74,27,21,20,24,13,17,20,12,48,44,30,32,-1
28.09.2025,2025,ger,162,Bonn,Syntainics MBC,95,80,26,16,20,27,20,14,29,23,42,47,34,52,1
28.09.2025,2025,ger,161,Rostock,Gottingen,102,74,21,19,23,17,35,13,23,25,40,40,48,48,1
28.09.2025,2025,ger,169,Alba Berlin,Oldenburg,105,70,28,11,20,28,28,20,29,11,39,48,48,40,1
28.09.2025,2025,ger,167,Ulm,Wurzburg,85,76,13,15,21,15,28,21,23,25,28,36,49,48,1
25.09.2025,2025,ger,168,Vechta,Bonn,83,75,18,13,14,21,21,19,30,22,31,35,40,52,1
29.09.2025,2025,ger b,158,Koblenz,Dresden,79,76,17,25,19,25,23,15,20,11,42,44,38,31,-1
29.09.2025,2025,ger b,164,Jena,Bremerhaven,81,75,18,24,24,22,18,20,21,9,42,46,38,30,-1
29.09.2025,2025,ger b,164,Giessen,PS Karlsruhe,66,64,12,15,14,23,22,12,18,14,27,37,34,32,-1
28.09.2025,2025,ger b,168,Crailsheim Merlins,Nurnberger,84,67,18,20,25,18,22,17,19,12,38,43,39,31,-1
28.09.2025,2025,ger b,171,Artland,Bayreuth,106,96,25,23,32,30,23,19,26,24,48,62,42,50,1
28.09.2025,2025,ger b,160,Tubingen,Munster,67,85,14,17,19,22,11,26,23,20,31,41,37,43,-1
28.09.2025,2025,ger b,164,Bochum,Dusseldorf,79,73,15,23,20,24,21,13,23,13,38,44,34,36,-1
28.09.2025,2025,ger b,162,Phoenix Hagen,Kirchheim,75,70,24,16,10,23,15,19,26,12,40,33,34,38,-1
28.09.2025,2025,ger b,164,Vechta 2,Trier,84,112,21,25,21,29,21,32,21,26,46,50,53,47,1
29.09.2025,2025,ita,165,Pistoia,Basket Napoli,88,82,29,24,27,19,10,20,22,19,53,46,30,41,-1
29.09.2025,2025,ita,176,Brescia,Varese,118,94,29,24,28,28,36,23,25,19,53,56,59,44,1
29.09.2025,2025,ita,165,Venezia,Treviso,75,78,23,24,15,21,16,19,21,14,47,36,35,35,-1
29.09.2025,2025,ita,157,Tortona,Cremona,80,68,27,24,18,13,17,22,18,9,51,31,39,27,-1
29.09.2025,2025,ita,156,Trieste,Olimpia Milano,84,78,21,22,26,18,17,12,20,26,43,44,29,46,-1
28.09.2025,2025,ita,159,Sassari,Scafati,86,97,21,22,16,19,23,22,26,34,43,35,45,60,1
28.09.2025,2025,ita,168,Trapani,Virtus Bologna,88,89,25,29,16,21,20,19,27,20,54,37,39,47,1
28.09.2025,2025,ita,164,Reggiana,Trento,76,92,16,24,23,22,22,25,15,21,40,45,47,36,1
29.09.2025,2025,ita b,154,Basket Torino,Verona,88,96,14,20,25,27,19,23,30,26,34,52,42,56,1
29.09.2025,2025,ita b,154,Brindisi,Avellino Basket,72,77,21,17,18,21,21,19,12,20,38,39,40,32,-1
29.09.2025,2025,ita b,155,Cento,Libertas Livorno,83,72,17,27,19,12,25,14,22,19,44,31,39,41,1
29.09.2025,2025,ita b,152,Cividale,Forli,77,69,20,17,16,17,14,10,27,25,37,33,24,52,-1
29.09.2025,2025,ita b,156,Nardo,Pesaro,78,86,16,12,11,33,28,30,23,11,28,44,58,34,1
29.09.2025,2025,ita b,161,Orzinuovi,Cantu,77,76,21,21,21,24,11,16,17,9,42,45,27,26,-1
29.09.2025,2025,ita b,148,Rimini,Udine,85,71,13,19,17,13,29,15,26,24,32,30,44,50,1
29.09.2025,2025,ita b,155,Urania Milano,Fortitudo Bologna,94,78,23,17,33,18,21,21,17,22,40,51,42,39,1
29.09.2025,2025,ita b,160,Vigevano,JuVi Cremona,73,79,24,12,11,25,19,17,19,25,36,36,36,44,-1
28.09.2025,2025,ita b,155,Sebastiani Rieti,Assigeco Piacenza,80,72,21,17,22,19,21,20,16,16,38,41,41,32,-1
29.09.2025,2025,lat lkl,168,Neptunas,Jonava,90,87,24,22,27,24,19,22,20,19,46,51,41,39,-1
29.09.2025,2025,lat lkl,164,Nevezis,Zalgiris Kaunas,76,89,19,27,19,24,23,20,15,18,46,43,43,33,-1
29.09.2025,2025,lat lkl,160,Mazeikiai,Siauliai,93,95,19,24,13,25,24,13,24,18,43,38,37,42,-1
28.09.2025,2025,lat lkl,165,Lietkabelis,BC Wolves,83,81,28,15,24,25,18,21,13,20,43,49,39,33,-1
28.09.2025,2025,lat lkl,170,Juventus,Rytas,78,86,21,28,17,26,20,17,20,15,49,43,37,35,-1
25.09.2025,2025,lat lkl,163,Jonava,Zalgiris Kaunas,72,93,20,22,16,24,19,26,17,21,42,40,45,38,1
25.09.2025,2025,lat lkl,168,Nevezis,Juventus,74,78,19,21,14,21,16,15,25,21,40,35,31,46,-1
29.09.2025,2025,rom,165,BC Steaua Bucuresti,Voluntari,68,75,19,19,16,22,15,21,18,13,38,38,36,31,-1
29.09.2025,2025,rom,167,Cluj-Napoca,CSM Oradea,61,72,16,20,14,16,15,16,16,20,36,30,31,36,-1
28.09.2025,2025,rom,159,Valcea,Arges Pitesti,68,63,27,20,11,21,15,11,15,11,47,32,26,26,-1
28.09.2025,2025,rom,167,Municipal Galati,Rapid Bucuresti,68,100,12,32,22,21,19,20,15,27,44,43,39,42,-1
28.09.2025,2025,rom,159,Petrolul Ploiesti,Corona Brasov,57,67,13,21,13,20,19,7,12,19,34,33,26,31,-1
27.09.2025,2025,rom,166,CSM Targu Mures,CSU Sibiu,89,75,21,22,22,21,23,10,23,22,43,43,33,45,-1
27.09.2025,2025,rom,149,SCM Craiova,Dinamo Bucharest,71,70,16,20,23,21,18,15,14,14,36,44,33,28,-1
25.09.2025,2025,rom,162,CSM Oradea,BC Steaua Bucuresti,94,67,23,17,16,19,28,9,27,22,40,35,37,49,1
29.09.2025,2025,vtb,,MBA Moscow,Lokomotiv Kuban,85,93,23,37,27,17,18,22,17,17,60,44,40,34,
29.09.2025,2025,vtb,149,Parma Perm,Astana,95,63,17,16,21,18,31,14,26,15,33,39,45,41,1
29.09.2025,2025,vtb,160,Unics Kazan,Zenit Petersburg,84,87,18,21,28,18,13,27,25,21,39,46,40,46,1
29.09.2025,2025,vtb,,Enisey,CSKA Moscow,71,82,20,23,16,17,14,20,21,22,43,33,34,43,
28.09.2025,2025,vtb,146,Nizhny Novgorod,Saratov,79,74,20,21,17,16,20,19,22,18,41,33,39,40,1
29.09.2025,2025,spa,168,Leyma Coruna,Real Madrid,86,85,16,22,21,22,23,19,26,22,38,43,42,48,1
29.09.2025,2025,spa,157,Bilbao,Breogan,90,72,22,17,20,22,22,22,26,11,39,42,44,37,1
29.09.2025,2025,spa,164,Tenerife,Baskonia,88,80,17,13,23,28,21,23,27,16,30,51,44,43,1
29.09.2025,2025,spa,164,Barcelona,Granada,91,65,19,11,24,10,18,26,30,18,30,34,44,48,1
29.09.2025,2025,spa,166,Basket Zaragoza,Forca Lleida,101,91,21,19,17,20,27,30,22,18,40,37,57,40,1
28.09.2025,2025,spa,172,Manresa,Valencia,77,73,22,16,27,18,12,17,16,22,38,45,29,38,-1
28.09.2025,2025,spa,165,MoraBanc Andorra,Gran Canaria,71,91,15,23,23,15,20,24,13,29,38,38,44,42,1
28.09.2025,2025,spa,162,Joventut Badalona,Murcia,91,76,28,16,22,27,17,18,24,15,44,49,35,39,-1
28.09.2025,2025,spa,161,Unicaja,Basquet Girona,90,73,19,10,20,17,28,23,23,23,29,37,51,46,1
29.09.2025,2025,swit,167,Regio Basel,Lugano Tigers,68,60,18,8,13,11,18,20,19,21,26,24,38,40,-1
28.09.2025,2025,swit,153,BBC Monthey,Neuchatel,78,86,30,27,16,22,19,24,13,13,57,38,43,26,-1
28.09.2025,2025,swit,162,SAM Massagno,Lausanne Basket,86,78,21,19,26,18,18,20,21,21,40,44,38,42,-1
28.09.2025,2025,swit,155,Sdent BBC Nyon,Geneva Lions,74,87,29,20,15,17,12,26,18,24,49,32,38,42,1
30.09.2025,2025,tur b,158,Trabzonspor,MKE Ankaragucu,98,92,31,22,23,27,15,21,29,22,53,50,36,51,1
29.09.2025,2025,tur b,155,Çağdaş Bodrum Spor,Final Spor,71,77,16,22,25,18,10,20,20,17,38,43,30,37,-1
29.09.2025,2025,tur b,158,OGM Ormanspor,Esenler Erokspor,61,81,18,30,19,22,15,11,9,18,48,41,26,27,-1
29.09.2025,2025,tur b,159,Harem Spor,Cayirova,72,75,23,16,16,20,21,22,12,17,39,36,43,29,-1
28.09.2025,2025,tur b,158,Fenerbahce 2,Bordo Sportif,90,75,23,18,25,16,25,22,17,19,41,41,47,36,1
28.09.2025,2025,tur b,153,Balikesir,Sigortam.net ITU,65,72,18,27,17,12,16,9,14,24,45,29,25,38,-1
28.09.2025,2025,tur b,151,CO Basket,Ankara Kolejliler,74,65,19,25,15,11,24,17,16,12,44,26,41,28,-1
28.09.2025,2025,tur b,159,Kapakli Spor,Konya BBSK,84,89,27,21,18,23,21,17,18,28,48,41,38,46,1
27.09.2025,2025,tur b,159,Gaziantep,Istanbul Anka Spor,81,77,19,17,18,21,26,18,18,21,36,39,44,39,1
30.09.2025,2025,friendly,157,Gimnasia (Arg),Hispano Americano (Arg),88,65,21,12,17,17,25,15,25,21,33,34,40,46,1
29.09.2025,2025,friendly,149,Paralimni (Cyp),Keravnos (Cyp),79,84,27,19,11,19,24,25,17,21,46,30,49,38,1
29.09.2025,2025,friendly,152,Apoel BC (Cyp),Mykonos (Gre),72,90,20,26,16,22,23,23,13,19,46,38,46,32,1
28.09.2025,2025,friendly,160,Oliveirense (Por),Portimonense (Por),71,56,21,14,16,19,15,11,19,12,35,35,26,31,-1
28.09.2025,2025,friendly,158,MZT Skopje (Mkd),Pelister (Mkd),78,64,19,21,16,16,21,13,22,14,40,32,34,36,-1
28.09.2025,2025,friendly,156,Imortal (Por),Galomar (Por),74,73,20,21,19,17,22,18,13,17,41,36,40,30,-1
28.09.2025,2025,friendly,155,Paralimni (Cyp),Mykonos (Gre),71,77,19,14,21,18,17,22,14,23,33,39,39,37,-1
28.09.2025,2025,friendly,150,Keravnos (Cyp),Apoel BC (Cyp),74,57,19,12,21,14,19,11,15,20,31,35,30,35,-1
28.09.2025,2025,friendly,151,AEK Larnaca (Cyp),ETHA Engomi (Cyp),104,67,30,13,24,20,31,19,19,15,43,44,50,34,1
28.09.2025,2025,friendly,155,Barrio Parque de Cordoba (Arg),Atenas (Arg),93,89,28,23,25,14,21,26,19,26,51,39,47,45,1
27.09.2025,2025,friendly,148,Galitos Aveiro (Por),Illiabum (Por),46,64,13,18,17,12,8,18,8,16,31,29,26,24,-1
27.09.2025,2025,friendly,152,Barreirense (Por),Santo Andre (Por),91,77,23,20,24,20,17,12,27,25,43,44,29,52,1
27.09.2025,2025,friendly,168,Suwon KT (Kor),Mobis Phoebus (Kor),87,85,20,25,26,25,24,20,17,15,45,51,44,32,-1
26.09.2025,2025,friendly,163,Gdynia (Pol),Czarni Slupsk (Pol),73,102,13,23,25,23,18,30,17,26,36,48,48,43,1
26.09.2025,2025,friendly,159,Beroe (Bul),Balkan (Bul),68,81,8,22,18,22,26,17,16,20,30,40,43,36,-1
26.09.2025,2025,friendly,168,Bursaspor (Tur),Yalovaspor (Tur),79,74,13,18,21,23,25,13,20,20,31,44,38,40,-1
26.09.2025,2025,friendly,164,Mobis Phoebus (Kor),Seoul Thunders (Kor),91,83,19,22,26,21,27,23,19,17,41,47,50,36,1
26.09.2025,2025,friendly,154,Regatas (Arg),Uniao Corinthians (Bra),70,68,19,15,17,22,13,12,21,19,34,39,25,40,-1
25.09.2025,2025,friendly,155,Cearense (Bra),Penarol (Arg),70,60,17,17,23,12,18,13,12,18,34,35,31,30,-1
25.09.2025,2025,friendly,156,Platense (Arg),Pato (Bra),85,69,31,13,12,16,24,21,18,19,44,28,45,37,1
25.09.2025,2025,friendly,,Leonesa (Esp),Ponferrada (Esp),75,87,19,23,22,25,21,15,13,24,42,47,36,37,
25.09.2025,2025,friendly,156,Anadolu Efes (Tur),Panathinaikos (Gre),90,75,29,9,22,27,27,25,12,14,38,49,52,26,-1
25.09.2025,2025,friendly,155,ETHA Engomi (Cyp),Apollon (Cyp),85,76,19,21,23,14,26,28,17,13,40,37,54,30,1
25.09.2025,2025,friendly,172,Al Ittihad Alexandria (Egy),Kuwait SC (Kuw),106,66,28,12,18,23,25,24,35,7,40,41,49,42,1
25.09.2025,2025,friendly,166,Sagesse Beirut (Leb),FUS Rabat (Mar),96,91,29,24,26,23,13,27,28,17,53,49,40,45,1
24.09.2025,2025,friendly,161,Galatasaray (Tur),Panathinaikos (Gre),56,85,12,17,22,17,11,24,11,27,29,39,35,38,-1
24.09.2025,2025,friendly,152,AEL (Cyp),Achilleas K. (Cyp),74,72,25,16,24,15,13,25,12,16,41,39,38,28,-1
24.09.2025,2025,friendly,165,Maccabi Rishon (Isr),Safed (Isr),97,92,29,23,27,17,20,24,21,28,52,44,44,49,1
24.09.2025,2025,friendly,166,Wonju DB (Kor),Suwon KT (Kor),86,83,27,17,22,20,17,19,20,27,44,42,36,47,-1
28.09.2025,2025,aus,150,Traiskirchen Lions,Kapfenberg Bulls,84,77,18,15,25,17,23,21,18,24,33,42,44,42,1
28.09.2025,2025,aus,157,Klosterneuburg Dukes,Furstenfeld,72,68,24,16,17,29,22,13,9,10,40,46,35,19,-1
27.09.2025,2025,aus,155,Graz UBSC,BBC Nord,92,72,22,12,29,17,26,23,15,20,34,46,49,35,1
27.09.2025,2025,aus,160,Vienna Basket,Swans Gmunden,88,83,17,29,21,17,22,20,28,17,46,38,42,45,1
28.09.2025,2025,mac,157,Szolnoki Olaj,KTE-Duna,75,69,14,21,24,8,21,17,16,23,35,32,38,39,-1
28.09.2025,2025,mac,163,NKA Pecs,OSE Lions,81,73,28,16,12,17,27,21,14,19,44,29,48,33,-1
28.09.2025,2025,mac,164,Szombathely,Pecsi VSK,94,58,27,21,18,6,16,19,33,12,48,24,35,45,-1
28.09.2025,2025,mac,169,Zalakeramia,Szedeak,103,70,25,20,28,19,27,13,23,18,45,47,40,41,-1
27.09.2025,2025,mac,159,Budapesti Honved Se,Atomeromu Paks,60,91,18,30,19,18,10,24,13,19,48,37,34,32,-1
27.09.2025,2025,mac,157,Soproni KC,DEAC,80,79,18,24,20,7,17,25,21,20,42,27,42,41,1
28.09.2025,2025,cro,155,Dubrovnik,Cibona,79,84,25,18,19,23,15,21,20,22,43,42,36,42,1
28.09.2025,2025,cro,162,GKK Sibenka,Dubrava,77,81,22,17,17,22,23,20,15,22,39,39,43,37,-1
28.09.2025,2025,cro,159,Cedevita Junior,Osijek,95,70,22,19,27,14,24,19,22,18,41,41,43,40,1
28.09.2025,2025,cro,155,Zadar,Alkar,94,47,25,12,27,7,29,19,13,9,37,34,48,22,-1
26.09.2025,2025,cro,157,Split,Kvarner,98,90,14,24,35,16,21,25,28,25,38,51,46,53,1
28.09.2025,2025,lat-st,155,Latvijas Universitate,Valmiera Glass Via,72,92,15,26,18,21,17,23,22,22,41,39,40,44,1
28.09.2025,2025,lat-st,155,BK Liepaja,BK Ogre,80,75,23,11,21,17,25,23,11,24,34,38,48,35,1
26.09.2025,2025,lat-st,155,BC Kalev/Cramo,VEF Riga,63,84,22,19,22,25,7,25,12,15,41,47,32,27,-1
26.09.2025,2025,lat-st,166,Ventspils,Rigas Zelli,85,84,29,18,19,18,27,28,10,20,47,37,55,30,1
21.09.2025,2025,lat-st,157,Rigas Zelli,VEF Riga,91,88,17,25,24,24,26,17,24,22,42,48,43,46,1
21.09.2025,2025,lat-st,152,BK Ogre,Latvijas Universitate,90,74,23,27,21,19,17,9,29,19,50,40,26,48,-1
20.09.2025,2025,lat-st,156,Valmiera Glass Via,BK Liepaja,80,63,22,13,23,16,11,19,24,15,35,39,30,39,-1
28.09.2025,2025,slovak,164,BKM Lucenec,x,90,88,30,28,21,20,25,18,14,22,58,41,43,36,-1
28.09.2025,2025,slovak,155,BC Komarno,x,107,76,24,19,38,16,19,22,26,19,43,54,41,45,1
28.09.2025,2025,slovak,163,Nitra Blue Wings,x,90,84,14,26,25,21,32,19,19,18,40,46,51,37,1
28.09.2025,2025,slovak,160,SPU Nitra,x,110,75,23,21,29,21,26,16,32,17,44,50,42,49,1
25.09.2025,2025,slovak,161,Inter Bratislava,x,73,76,18,13,17,21,18,15,20,27,31,38,33,47,-1
25.09.2025,2025,slovak,163,Levice,x,61,84,15,24,22,17,9,18,15,25,39,39,27,40,-1
25.09.2025,2025,slovak,160,MBK Handlova,x,53,78,9,17,11,15,14,22,19,24,26,26,36,43,-1
25.09.2025,2025,slovak,159,Iskra Svit,x,84,91,22,28,20,28,24,17,18,18,50,48,41,36,-1
21.09.2025,2025,slovak,154,BC Prievidza,x,99,85,21,19,19,18,29,22,30,26,40,37,51,56,1
21.09.2025,2025,slovak,163,Iskra Svit,x,67,54,16,16,13,12,19,12,19,14,32,25,31,33,-1
21.09.2025,2025,slovak,150,SPU Nitra,x,94,70,29,11,25,23,27,24,13,12,40,48,51,25,1
21.09.2025,2025,slovak,162,BC Komarno,x,100,87,31,20,19,19,29,28,21,20,51,38,57,41,1
29.09.2025,2025,avst,183,South East Melbourne,x,81,79,11,21,22,15,27,23,21,20,32,37,50,41,-1
29.09.2025,2025,avst,192,Illawarra Hawks,x,89,96,15,27,32,21,20,27,22,21,42,53,47,43,-1
28.09.2025,2025,avst,173,Melbourne United,x,81,72,20,14,24,19,17,16,20,23,34,43,33,43,-1
28.09.2025,2025,avst,176,Adelaide,x,101,97,28,32,30,22,19,23,24,20,60,52,42,44,-1
27.09.2025,2025,avst,190,Sydney,x,87,88,11,27,29,16,18,24,29,21,38,45,42,50,-1
27.09.2025,2025,avst,183,Brisbane Bullets,x,113,101,38,25,21,35,30,20,24,21,63,56,50,45,1
26.09.2025,2025,avst,188,Melbourne United,x,84,96,28,21,12,25,20,21,24,29,49,37,41,53,-1
29.09.2025,2025,cek,158,Pardubice,x,88,81,23,30,23,20,18,23,24,8,53,43,41,32,-1
29.09.2025,2025,cek,166,USK Prague,x,99,89,26,24,27,30,20,19,26,16,50,57,39,42,-1
28.09.2025,2025,cek,169,Jindrichuv Hradec,x,95,73,25,18,23,15,18,15,29,25,43,38,33,54,1
28.09.2025,2025,cek,167,Brno,x,67,78,13,27,19,12,23,18,12,21,40,31,41,33,-1
28.09.2025,2025,cek,161,NH Ostrava,x,89,87,23,25,24,22,20,18,22,22,48,46,38,44,1
28.09.2025,2025,cek,166,Nymburk,x,75,94,14,19,20,25,14,21,27,29,33,45,35,56,1
29.09.2025,2025,aba,164,Partizan,x,80,89,25,24,19,17,15,18,21,30,49,36,33,51,1
29.09.2025,2025,aba,165,Dubai,x,84,92,17,29,25,34,18,20,24,9,46,59,38,33,-1
29.09.2025,2025,aba,164,FMP Beograd,x,83,80,17,24,21,21,19,17,26,18,41,42,36,44,-1
28.09.2025,2025,aba,159,Split,x,97,75,33,13,26,27,19,14,19,21,46,53,33,40,-1
28.09.2025,2025,aba,166,Mornar Bar,x,91,72,22,14,23,27,22,17,24,14,36,50,39,38,-1
26.09.2025,2025,aba,161,Subotica,x,84,76,20,24,34,22,13,14,17,16,44,56,27,33,-1
29.09.2025,2025,bnxt,154,Circus Brussels,x,84,81,22,26,23,24,17,16,22,15,48,47,33,37,-1
28.09.2025,2025,bnxt,156,Okapi Aalst,x,76,69,11,14,20,15,21,22,13,14,25,35,43,27,-1
28.09.2025,2025,bnxt,155,Mechelen,x,75,79,16,22,19,19,26,12,14,26,38,38,38,40,1
28.09.2025,2025,bnxt,154,QSTA Utd,x,82,76,19,21,24,19,10,27,29,9,40,43,37,38,-1
28.09.2025,2025,bnxt,157,LWD Basket,x,97,99,28,22,19,22,18,16,17,22,50,41,34,39,-1
28.09.2025,2025,bnxt,146,Leuven Bears,x,78,77,13,19,29,16,16,18,20,24,32,45,34,44,1
28.09.2025,2025,bnxt,162,Kortrijk,x,70,99,26,22,9,27,16,25,19,25,48,36,41,44,1
27.09.2025,2025,bnxt,152,Den Helder,x,84,44,15,11,22,8,25,7,22,18,26,30,32,40,-1
25.09.2025,2025,bnxt,155,Antwerp Giants,x,67,65,19,14,20,21,13,13,15,17,33,41,26,32,-1
29.09.2025,2025,fra,158,Lyon-Villeurbanne,x,85,94,21,32,24,17,19,23,21,22,53,41,42,43,1
29.09.2025,2025,fra,153,Limoges,x,70,56,23,9,14,13,22,9,11,25,32,27,31,36,-1
29.09.2025,2025,fra,157,Strasbourg,x,77,65,19,24,16,16,20,12,22,13,43,32,32,35,-1
28.09.2025,2025,fra,165,Paris,x,87,102,23,27,17,26,27,27,20,22,50,43,54,42,1
28.09.2025,2025,fra,150,Saint Quentin,x,69,83,18,24,17,25,21,16,13,18,42,42,37,31,-1
28.09.2025,2025,fra,164,Le Portel,x,74,65,19,19,24,21,16,12,15,13,38,45,28,28,-1
27.09.2025,2025,fra,149,Cholet,x,64,78,9,17,18,20,20,24,17,17,26,38,44,34,1
28.09.2025,2025,fra b,164,Aix Maurienne,x,97,82,21,19,34,16,17,24,25,23,40,50,41,48,1
27.09.2025,2025,fra b,152,Antibes,x,92,87,25,21,23,19,15,22,29,25,46,42,37,54,1
27.09.2025,2025,fra b,154,Orleans,x,83,90,17,20,15,15,21,23,21,16,37,30,44,37,1
27.09.2025,2025,fra b,157,Poitiers,x,79,87,25,18,14,20,9,21,31,28,43,34,30,59,1
27.09.2025,2025,fra b,167,St. Chamond,x,86,79,22,22,17,12,25,19,22,26,44,29,44,48,1
27.09.2025,2025,fra b,148,Nantes,x,81,75,20,13,17,22,23,17,21,23,33,39,40,44,1
27.09.2025,2025,fra b,157,Fos-sur-Mer,x,69,75,16,14,21,19,15,20,17,22,30,40,35,39,-1
27.09.2025,2025,fra b,157,ASA,x,80,79,24,25,19,20,12,19,25,15,49,39,31,40,-1
27.09.2025,2025,fra b,160,Caen,x,79,65,19,16,15,19,20,12,25,18,35,34,32,43,-1
27.09.2025,2025,fra b,157,Denain-Voltaire,x,76,92,18,19,17,14,22,27,19,32,37,31,49,51,1
29.09.2025,2025,ger,163,Bamberg,x,58,66,15,19,15,13,13,18,15,16,34,28,31,31,-1
29.09.2025,2025,ger,163,Hamburg,x,81,80,21,21,21,20,16,19,23,20,42,41,35,43,-1
29.09.2025,2025,ger,173,Vechta,x,80,74,27,21,20,24,13,17,20,12,48,44,30,32,-1
28.09.2025,2025,ger,162,Syntainics MBC,x,95,80,26,16,20,27,20,14,29,23,42,47,34,52,1
28.09.2025,2025,ger,161,Gottingen,x,102,74,21,19,23,17,35,13,23,25,40,40,48,48,1
28.09.2025,2025,ger,169,Oldenburg,x,105,70,28,11,20,28,28,20,29,11,39,48,48,40,1
28.09.2025,2025,ger,167,Wurzburg,x,85,76,13,15,21,15,28,21,23,25,28,36,49,48,1
25.09.2025,2025,ger,168,Bonn,x,83,75,18,13,14,21,21,19,30,22,31,35,40,52,1
29.09.2025,2025,ger b,158,Dresden,x,79,76,17,25,19,25,23,15,20,11,42,44,38,31,-1
29.09.2025,2025,ger b,164,Bremerhaven,x,81,75,18,24,24,22,18,20,21,9,42,46,38,30,-1
29.09.2025,2025,ger b,164,PS Karlsruhe,x,66,64,12,15,14,23,22,12,18,14,27,37,34,32,-1
28.09.2025,2025,ger b,168,Nurnberger,x,84,67,18,20,25,18,22,17,19,12,38,43,39,31,-1
28.09.2025,2025,ger b,171,Bayreuth,x,106,96,25,23,32,30,23,19,26,24,48,62,42,50,1
28.09.2025,2025,ger b,160,Munster,x,67,85,14,17,19,22,11,26,23,20,31,41,37,43,-1
28.09.2025,2025,ger b,164,Dusseldorf,x,79,73,15,23,20,24,21,13,23,13,38,44,34,36,-1
28.09.2025,2025,ger b,162,Kirchheim,x,75,70,24,16,10,23,15,19,26,12,40,33,34,38,-1
28.09.2025,2025,ger b,164,Trier,x,84,112,21,25,21,29,21,32,21,26,46,50,53,47,1
29.09.2025,2025,ita,165,Basket Napoli,x,88,82,29,24,27,19,10,20,22,19,53,46,30,41,-1
29.09.2025,2025,ita,176,Varese,x,118,94,29,24,28,28,36,23,25,19,53,56,59,44,1
29.09.2025,2025,ita,165,Treviso,x,75,78,23,24,15,21,16,19,21,14,47,36,35,35,-1
29.09.2025,2025,ita,157,Cremona,x,80,68,27,24,18,13,17,22,18,9,51,31,39,27,-1
29.09.2025,2025,ita,156,Olimpia Milano,x,84,78,21,22,26,18,17,12,20,26,43,44,29,46,-1
28.09.2025,2025,ita,159,Scafati,x,86,97,21,22,16,19,23,22,26,34,43,35,45,60,1
28.09.2025,2025,ita,168,Virtus Bologna,x,88,89,25,29,16,21,20,19,27,20,54,37,39,47,1
28.09.2025,2025,ita,164,Trento,x,76,92,16,24,23,22,22,25,15,21,40,45,47,36,1
29.09.2025,2025,ita b,154,Verona,x,88,96,14,20,25,27,19,23,30,26,34,52,42,56,1
29.09.2025,2025,ita b,154,Avellino Basket,x,72,77,21,17,18,21,21,19,12,20,38,39,40,32,-1
29.09.2025,2025,ita b,155,Libertas Livorno,x,83,72,17,27,19,12,25,14,22,19,44,31,39,41,1
29.09.2025,2025,ita b,152,Forli,x,77,69,20,17,16,17,14,10,27,25,37,33,24,52,-1
29.09.2025,2025,ita b,156,Pesaro,x,78,86,16,12,11,33,28,30,23,11,28,44,58,34,1
29.09.2025,2025,ita b,161,Cantu,x,77,76,21,21,21,24,11,16,17,9,42,45,27,26,-1
29.09.2025,2025,ita b,148,Udine,x,85,71,13,19,17,13,29,15,26,24,32,30,44,50,1
29.09.2025,2025,ita b,155,Fortitudo Bologna,x,94,78,23,17,33,18,21,21,17,22,40,51,42,39,1
29.09.2025,2025,ita b,160,JuVi Cremona,x,73,79,24,12,11,25,19,17,19,25,36,36,36,44,-1
28.09.2025,2025,ita b,155,Assigeco Piacenza,x,80,72,21,17,22,19,21,20,16,16,38,41,41,32,-1
29.09.2025,2025,lat lkl,168,Jonava,x,90,87,24,22,27,24,19,22,20,19,46,51,41,39,-1
29.09.2025,2025,lat lkl,164,Zalgiris Kaunas,x,76,89,19,27,19,24,23,20,15,18,46,43,43,33,-1
29.09.2025,2025,lat lkl,160,Siauliai,x,93,95,19,24,13,25,24,13,24,18,43,38,37,42,-1
28.09.2025,2025,lat lkl,165,BC Wolves,x,83,81,28,15,24,25,18,21,13,20,43,49,39,33,-1
28.09.2025,2025,lat lkl,170,Rytas,x,78,86,21,28,17,26,20,17,20,15,49,43,37,35,-1
25.09.2025,2025,lat lkl,163,Zalgiris Kaunas,x,72,93,20,22,16,24,19,26,17,21,42,40,45,38,1
25.09.2025,2025,lat lkl,168,Juventus,x,74,78,19,21,14,21,16,15,25,21,40,35,31,46,-1
29.09.2025,2025,rom,165,Voluntari,x,68,75,19,19,16,22,15,21,18,13,38,38,36,31,-1
29.09.2025,2025,rom,167,CSM Oradea,x,61,72,16,20,14,16,15,16,16,20,36,30,31,36,-1
28.09.2025,2025,rom,159,Arges Pitesti,x,68,63,27,20,11,21,15,11,15,11,47,32,26,26,-1
28.09.2025,2025,rom,167,Rapid Bucuresti,x,68,100,12,32,22,21,19,20,15,27,44,43,39,42,-1
28.09.2025,2025,rom,159,Corona Brasov,x,57,67,13,21,13,20,19,7,12,19,34,33,26,31,-1
27.09.2025,2025,rom,166,CSU Sibiu,x,89,75,21,22,22,21,23,10,23,22,43,43,33,45,-1
27.09.2025,2025,rom,149,Dinamo Bucharest,x,71,70,16,20,23,21,18,15,14,14,36,44,33,28,-1
25.09.2025,2025,rom,162,BC Steaua Bucuresti,x,94,67,23,17,16,19,28,9,27,22,40,35,37,49,1
29.09.2025,2025,vtb,,Lokomotiv Kuban,x,85,93,23,37,27,17,18,22,17,17,60,44,40,34,
29.09.2025,2025,vtb,149,Astana,x,95,63,17,16,21,18,31,14,26,15,33,39,45,41,1
29.09.2025,2025,vtb,160,Zenit Petersburg,x,84,87,18,21,28,18,13,27,25,21,39,46,40,46,1
29.09.2025,2025,vtb,,CSKA Moscow,x,71,82,20,23,16,17,14,20,21,22,43,33,34,43,
28.09.2025,2025,vtb,146,Saratov,x,79,74,20,21,17,16,20,19,22,18,41,33,39,40,1
29.09.2025,2025,spa,168,Real Madrid,x,86,85,16,22,21,22,23,19,26,22,38,43,42,48,1
29.09.2025,2025,spa,157,Breogan,x,90,72,22,17,20,22,22,22,26,11,39,42,44,37,1
29.09.2025,2025,spa,164,Baskonia,x,88,80,17,13,23,28,21,23,27,16,30,51,44,43,1
29.09.2025,2025,spa,164,Granada,x,91,65,19,11,24,10,18,26,30,18,30,34,44,48,1
29.09.2025,2025,spa,166,Forca Lleida,x,101,91,21,19,17,20,27,30,22,18,40,37,57,40,1
28.09.2025,2025,spa,172,Valencia,x,77,73,22,16,27,18,12,17,16,22,38,45,29,38,-1
28.09.2025,2025,spa,165,Gran Canaria,x,71,91,15,23,23,15,20,24,13,29,38,38,44,42,1
28.09.2025,2025,spa,162,Murcia,x,91,76,28,16,22,27,17,18,24,15,44,49,35,39,-1
28.09.2025,2025,spa,161,Basquet Girona,x,90,73,19,10,20,17,28,23,23,23,29,37,51,46,1
29.09.2025,2025,swit,167,Lugano Tigers,x,68,60,18,8,13,11,18,20,19,21,26,24,38,40,-1
28.09.2025,2025,swit,153,Neuchatel,x,78,86,30,27,16,22,19,24,13,13,57,38,43,26,-1
28.09.2025,2025,swit,162,Lausanne Basket,x,86,78,21,19,26,18,18,20,21,21,40,44,38,42,-1
28.09.2025,2025,swit,155,Geneva Lions,x,74,87,29,20,15,17,12,26,18,24,49,32,38,42,1
30.09.2025,2025,tur b,158,MKE Ankaragucu,x,98,92,31,22,23,27,15,21,29,22,53,50,36,51,1
29.09.2025,2025,tur b,155,Final Spor,x,71,77,16,22,25,18,10,20,20,17,38,43,30,37,-1
29.09.2025,2025,tur b,158,Esenler Erokspor,x,61,81,18,30,19,22,15,11,9,18,48,41,26,27,-1
29.09.2025,2025,tur b,159,Cayirova,x,72,75,23,16,16,20,21,22,12,17,39,36,43,29,-1
28.09.2025,2025,tur b,158,Bordo Sportif,x,90,75,23,18,25,16,25,22,17,19,41,41,47,36,1
28.09.2025,2025,tur b,153,iLab Basketbol,x,65,72,18,27,17,12,16,9,14,24,45,29,25,38,-1
28.09.2025,2025,tur b,151,Ankara Kolejliler,x,74,65,19,25,15,11,24,17,16,12,44,26,41,28,-1
28.09.2025,2025,tur b,159,Konya BBSK,x,84,89,27,21,18,23,21,17,18,28,48,41,38,46,1
27.09.2025,2025,tur b,159,Istanbul Anka Spor,x,81,77,19,17,18,21,26,18,18,21,36,39,44,39,1
30.09.2025,2025,friendly,157,Hispano Americano (Arg),x,88,65,21,12,17,17,25,15,25,21,33,34,40,46,1
29.09.2025,2025,friendly,149,Keravnos (Cyp),x,79,84,27,19,11,19,24,25,17,21,46,30,49,38,1
29.09.2025,2025,friendly,152,Mykonos (Gre),x,72,90,20,26,16,22,23,23,13,19,46,38,46,32,1
28.09.2025,2025,friendly,160,Portimonense (Por),x,71,56,21,14,16,19,15,11,19,12,35,35,26,31,-1
28.09.2025,2025,friendly,158,Pelister (Mkd),x,78,64,19,21,16,16,21,13,22,14,40,32,34,36,-1
28.09.2025,2025,friendly,156,Galomar (Por),x,74,73,20,21,19,17,22,18,13,17,41,36,40,30,-1
28.09.2025,2025,friendly,155,Mykonos (Gre),x,71,77,19,14,21,18,17,22,14,23,33,39,39,37,-1
28.09.2025,2025,friendly,150,Apoel BC (Cyp),x,74,57,19,12,21,14,19,11,15,20,31,35,30,35,-1
28.09.2025,2025,friendly,151,ETHA Engomi (Cyp),x,104,67,30,13,24,20,31,19,19,15,43,44,50,34,1
28.09.2025,2025,friendly,155,Atenas (Arg),x,93,89,28,23,25,14,21,26,19,26,51,39,47,45,1
27.09.2025,2025,friendly,148,Illiabum (Por),x,46,64,13,18,17,12,8,18,8,16,31,29,26,24,-1
27.09.2025,2025,friendly,152,Santo Andre (Por),x,91,77,23,20,24,20,17,12,27,25,43,44,29,52,1
27.09.2025,2025,friendly,168,Mobis Phoebus (Kor),x,87,85,20,25,26,25,24,20,17,15,45,51,44,32,-1
26.09.2025,2025,friendly,163,Czarni Slupsk (Pol),x,73,102,13,23,25,23,18,30,17,26,36,48,48,43,1
26.09.2025,2025,friendly,159,Balkan (Bul),x,68,81,8,22,18,22,26,17,16,20,30,40,43,36,-1
26.09.2025,2025,friendly,168,Yalovaspor (Tur),x,79,74,13,18,21,23,25,13,20,20,31,44,38,40,-1
26.09.2025,2025,friendly,164,Seoul Thunders (Kor),x,91,83,19,22,26,21,27,23,19,17,41,47,50,36,1
26.09.2025,2025,friendly,154,Uniao Corinthians (Bra),x,70,68,19,15,17,22,13,12,21,19,34,39,25,40,-1
25.09.2025,2025,friendly,155,Penarol (Arg),x,70,60,17,17,23,12,18,13,12,18,34,35,31,30,-1
25.09.2025,2025,friendly,156,Pato (Bra),x,85,69,31,13,12,16,24,21,18,19,44,28,45,37,1
25.09.2025,2025,friendly,,Ponferrada (Esp),x,75,87,19,23,22,25,21,15,13,24,42,47,36,37,
25.09.2025,2025,friendly,156,Panathinaikos (Gre),x,90,75,29,9,22,27,27,25,12,14,38,49,52,26,-1
25.09.2025,2025,friendly,155,Apollon (Cyp),x,85,76,19,21,23,14,26,28,17,13,40,37,54,30,1
25.09.2025,2025,friendly,172,Kuwait SC (Kuw),x,106,66,28,12,18,23,25,24,35,7,40,41,49,42,1
25.09.2025,2025,friendly,166,FUS Rabat (Mar),x,96,91,29,24,26,23,13,27,28,17,53,49,40,45,1
24.09.2025,2025,friendly,161,Panathinaikos (Gre),x,56,85,12,17,22,17,11,24,11,27,29,39,35,38,-1
24.09.2025,2025,friendly,152,Achilleas K. (Cyp),x,74,72,25,16,24,15,13,25,12,16,41,39,38,28,-1
24.09.2025,2025,friendly,165,Safed (Isr),x,97,92,29,23,27,17,20,24,21,28,52,44,44,49,1
24.09.2025,2025,friendly,166,Suwon KT (Kor),x,86,83,27,17,22,20,17,19,20,27,44,42,36,47,-1
28.09.2025,2025,aus,150,Kapfenberg Bulls,x,84,77,18,15,25,17,23,21,18,24,33,42,44,42,1
28.09.2025,2025,aus,157,Furstenfeld,x,72,68,24,16,17,29,22,13,9,10,40,46,35,19,-1
27.09.2025,2025,aus,155,BBC Nord,x,92,72,22,12,29,17,26,23,15,20,34,46,49,35,1
27.09.2025,2025,aus,160,Swans Gmunden,x,88,83,17,29,21,17,22,20,28,17,46,38,42,45,1
28.09.2025,2025,mac,157,KTE-Duna,x,75,69,14,21,24,8,21,17,16,23,35,32,38,39,-1
28.09.2025,2025,mac,163,OSE Lions,x,81,73,28,16,12,17,27,21,14,19,44,29,48,33,-1
28.09.2025,2025,mac,164,Pecsi VSK,x,94,58,27,21,18,6,16,19,33,12,48,24,35,45,-1
28.09.2025,2025,mac,169,Szedeak,x,103,70,25,20,28,19,27,13,23,18,45,47,40,41,-1
27.09.2025,2025,mac,159,Atomeromu Paks,x,60,91,18,30,19,18,10,24,13,19,48,37,34,32,-1
27.09.2025,2025,mac,157,DEAC,x,80,79,18,24,20,7,17,25,21,20,42,27,42,41,1
28.09.2025,2025,cro,155,Cibona,x,79,84,25,18,19,23,15,21,20,22,43,42,36,42,1
28.09.2025,2025,cro,162,Dubrava,x,77,81,22,17,17,22,23,20,15,22,39,39,43,37,-1
28.09.2025,2025,cro,159,Osijek,x,95,70,22,19,27,14,24,19,22,18,41,41,43,40,1
28.09.2025,2025,cro,155,Alkar,x,94,47,25,12,27,7,29,19,13,9,37,34,48,22,-1
26.09.2025,2025,cro,157,Kvarner,x,98,90,14,24,35,16,21,25,28,25,38,51,46,53,1
28.09.2025,2025,lat-st,155,Valmiera Glass Via,x,72,92,15,26,18,21,17,23,22,22,41,39,40,44,1
28.09.2025,2025,lat-st,155,BK Ogre,x,80,75,23,11,21,17,25,23,11,24,34,38,48,35,1
26.09.2025,2025,lat-st,155,VEF Riga,x,63,84,22,19,22,25,7,25,12,15,41,47,32,27,-1
26.09.2025,2025,lat-st,166,Rigas Zelli,x,85,84,29,18,19,18,27,28,10,20,47,37,55,30,1
21.09.2025,2025,lat-st,157,VEF Riga,x,91,88,17,25,24,24,26,17,24,22,42,48,43,46,1
21.09.2025,2025,lat-st,152,Latvijas Universitate,x,90,74,23,27,21,19,17,9,29,19,50,40,26,48,-1
20.09.2025,2025,lat-st,156,BK Liepaja,x,80,63,22,13,23,16,11,19,24,15,35,39,30,39,-1
30.09.2025,2025,sloven,159,Helios Domzale,Sencur,79,57,21,16,12,11,27,16,19,14,37,23,43,33,-1
28.09.2025,2025,sloven,160,Zlatorog Lasko,LTH Castings,84,74,22,22,20,13,31,19,11,20,44,33,50,31,1
28.09.2025,2025,sloven,149,KK Triglav Kranj,Tajfun Sentjur,67,70,15,10,14,15,12,18,26,27,25,29,30,53,1
27.09.2025,2025,sloven,161,Ilirija,Rogaska,82,65,17,22,22,13,17,16,26,14,39,35,33,40,-1
25.09.2025,2025,sloven,160,KK Krka Novo mesto,Podcetrtek,76,83,18,24,27,13,19,27,12,19,42,40,46,31,-1
30.09.2025,2025,sloven,159,Sencur,x,79,57,21,16,12,11,27,16,19,14,37,23,43,33,-1
28.09.2025,2025,sloven,160,LTH Castings,x,84,74,22,22,20,13,31,19,11,20,44,33,50,31,1
28.09.2025,2025,sloven,149,Tajfun Sentjur,x,67,70,15,10,14,15,12,18,26,27,25,29,30,53,1
27.09.2025,2025,sloven,161,Rogaska,x,82,65,17,22,22,13,17,16,26,14,39,35,33,40,-1
25.09.2025,2025,sloven,160,Podcetrtek,x,76,83,18,24,27,13,19,27,12,19,42,40,46,31,-1
04.10.2025,2025,avst,185,Perth,Melbourne United,68,97,22,31,19,33,13,19,14,14,53,52,32,28,-1
04.10.2025,2025,avst,170,Cairns Taipans,Tasmania JackJumpers,90,78,27,21,26,16,18,24,19,17,48,42,42,36,-1
03.10.2025,2025,avst,186,Adelaide,South East Melbourne,93,83,25,16,27,19,19,23,22,25,41,46,42,47,-1
04.10.2025,2025,fra,159,Strasbourg,Le Mans,88,95,12,23,20,20,24,20,32,32,35,40,44,64,1
01.10.2025,2025,fra,156,Dijon,Nancy,93,84,23,21,27,16,21,25,22,22,44,43,46,44,1
04.10.2025,2025,mac,151,DEAC,Budapesti Honved Se,84,66,21,14,18,18,20,15,25,19,35,36,35,44,1
04.10.2025,2025,mac,174,Atomeromu Paks,Alba Fehervar,92,85,26,20,20,22,23,25,23,18,46,42,48,41,1
03.10.2025,2025,mac,164,Szedeak,Szolnoki Olaj,71,83,19,19,22,18,11,32,19,14,38,40,43,33,-1
01.10.2025,2025,mac,175,Alba Fehervar,Kormend,114,86,33,25,30,25,32,16,19,20,58,55,48,39,-1
01.10.2025,2025,mac,158,Szolnoki Olaj,OSE Lions,78,71,18,16,23,26,19,16,18,13,34,49,35,31,-1
04.10.2025,2025,pol,163,Zielona Gora,Anwil Wloclawek,70,97,21,25,18,25,21,23,10,24,46,43,44,34,-1
04.10.2025,2025,pol,161,Gornik Walbrzych,Szczecin,72,82,18,20,24,24,21,24,9,14,38,48,45,23,-1
04.10.2025,2025,rom,163,Corona Brasov,CSM Targu Mures,80,75,18,18,23,17,19,18,20,22,36,40,37,42,-1
04.10.2025,2025,rom,162,Voluntari,Cluj-Napoca,87,102,21,30,17,26,23,21,26,25,51,43,44,51,1
04.10.2025,2025,rom,158,BC Timisoara,CSM Constanta,88,80,14,12,17,18,22,25,13,11,26,35,47,24,-1
04.10.2025,2025,swit,159,Fribourg Olympic,Regio Basel,106,59,27,15,25,13,25,13,29,18,42,38,38,47,1
01.10.2025,2025,swit,158,Lausanne Basket,Fribourg Olympic,54,97,12,22,19,27,8,22,15,26,34,46,30,41,-1
03.10.2025,2025,bnxt,168,Den Bosch,Kortrijk,80,87,18,22,24,23,20,20,18,22,40,47,40,40,-1
02.10.2025,2025,bnxt,155,Spirou Charleroi,BAL Weert,78,89,17,12,19,27,16,14,24,23,29,46,30,47,-1
02.10.2025,2025,bnxt,149,Antwerp Giants,Leuven Bears,78,83,21,23,19,23,19,21,19,16,44,42,40,35,1
03.10.2025,2025,ger,167,Syntainics MBC,Heidelberg,93,108,15,30,26,29,25,25,27,24,45,55,50,51,1
02.10.2025,2025,ger,160,Ludwigsburg,Rostock,70,64,18,17,16,15,24,17,12,15,35,31,41,27,-1
30.09.2025,2025,ger,163,Basketball Braunschweig,Ludwigsburg,91,71,29,14,22,23,26,12,14,22,43,45,38,36,-1
03.10.2025,2025,lat nkl,,BC Olimpas Palanga,Plunges Olimpas,80,49,17,8,19,4,20,13,24,24,25,23,33,48,
03.10.2025,2025,lat nkl,161,Kretinga,Vilkaviskis,93,85,25,14,24,22,20,30,24,19,39,46,50,43,1
03.10.2025,2025,lat nkl,166,Rytas 2,Klaipedos Neptunas,59,81,22,14,11,18,11,26,15,23,36,29,37,38,-1
03.10.2025,2025,lat nkl,144,Ukmerges Stekas,Zalgiris Kaunas 2,81,71,22,22,20,18,18,7,21,24,44,38,25,45,-1
03.10.2025,2025,lat nkl,,Alytaus Alytus,Silute,75,83,19,21,22,18,22,22,12,22,40,40,44,34,
03.10.2025,2025,lat nkl,160,Omega-Tauras,Delikatesas Joniskis,88,74,27,13,22,20,19,16,20,25,40,42,35,45,-1
03.10.2025,2025,lat nkl,160,Telsiai,Jurbarkas,85,67,25,17,18,16,21,12,21,22,42,34,33,43,-1
03.10.2025,2025,vtb,160,Zenit Petersburg,Parma Perm,100,56,18,10,28,12,32,19,22,15,28,40,51,37,1
02.10.2025,2025,vtb,155,MBA Moscow,Samara,79,86,23,22,17,20,20,24,19,20,45,37,44,39,1
02.10.2025,2025,vtb,154,Nizhny Novgorod,Uralmash Ekaterinburg,75,89,21,26,18,20,11,22,25,21,47,38,33,46,1
02.10.2025,2025,vtb,165,Astana,CSKA Moscow,48,91,18,29,12,18,12,28,6,16,47,30,40,22,-1
02.10.2025,2025,vtb,166,Saratov,Lokomotiv Kuban,84,87,17,21,15,21,20,23,32,22,38,36,43,54,1
02.10.2025,2025,vtb,155,Enisey,Unics Kazan,57,72,17,19,11,14,9,19,20,20,36,25,28,40,-1
03.10.2025,2025,sloven,161,Helios Domzale,Podcetrtek,72,67,25,14,11,21,21,9,15,23,39,32,30,38,-1
02.10.2025,2025,sloven,153,KK Triglav Kranj,KK Krka Novo mesto,57,90,25,21,15,30,7,17,10,22,46,45,24,32,-1
03.10.2025,2025,ukr,,Goverla,Rivne,65,84,13,22,18,21,14,21,20,20,35,39,35,40,
02.10.2025,2025,cek,155,USK Prague,Slavia Prague,81,63,22,17,24,15,21,19,14,12,39,39,40,26,-1
02.10.2025,2025,cek,173,Decin,Srsni Pisek,85,97,24,22,27,34,13,27,21,14,46,61,40,35,-1
02.10.2025,2025,cek,168,Jindrichuv Hradec,Pardubice,57,76,14,28,15,18,11,14,17,16,42,33,25,33,-1
02.10.2025,2025,cek,173,NH Ostrava,Olomoucko,99,94,34,22,17,27,23,15,25,30,56,44,38,55,1
02.10.2025,2025,eurocup,170,Valencia,Hamburg,105,78,30,29,22,15,30,21,23,13,59,37,51,36,1
02.10.2025,2025,eurocup,165,Trento,Trefl Sopot,84,78,25,15,19,21,17,28,23,14,40,40,45,37,-1
02.10.2025,2025,eurocup,166,JL Bourg,Cluj-Napoca,84,73,24,15,18,21,26,10,16,27,39,39,36,43,-1
02.10.2025,2025,eurocup,152,Aris,Turk Telekom,63,68,13,21,13,15,21,11,16,21,34,28,32,37,-1
01.10.2025,2025,eurocup,163,Buducnost,Gran Canaria,86,89,25,20,19,18,14,24,23,19,45,37,38,42,-1
01.10.2025,2025,eurocup,166,Cedevita Olimpija,Venezia,87,82,21,17,18,27,21,17,27,21,38,45,38,48,1
01.10.2025,2025,eurocup,169,Hapoel Tel-Aviv,BC Wolves,89,84,26,20,27,21,16,28,20,15,46,48,44,35,-1
01.10.2025,2025,eurocup,165,Ulm,Joventut Badalona,87,83,25,17,18,19,16,16,28,31,42,37,32,59,1
01.10.2025,2025,eurocup,162,Bahcesehir Kol.,Besiktas,87,66,23,21,24,11,20,14,20,20,44,35,34,40,-1
01.10.2025,2025,eurocup,160,Lietkabelis,Hapoel Jerusalem,74,94,25,18,11,26,20,16,18,34,43,37,36,52,1
02.10.2025,2025,fiba,166,Manresa,Benfica,92,64,31,17,21,20,27,15,13,12,48,41,42,25,-1
02.10.2025,2025,fiba,158,Tortona,Chemnitz,87,81,22,17,25,25,21,18,19,21,39,50,39,40,-1
02.10.2025,2025,fiba,158,FMP Beograd,Peristeri,70,58,18,14,14,8,17,10,21,26,32,22,27,47,-1
02.10.2025,2025,fiba,155,Slask Wroclaw,Szombathely,75,84,13,22,23,16,21,21,18,25,35,39,42,43,1
02.10.2025,2025,fiba,158,Igokea,Nanterre,86,80,19,15,20,27,29,19,18,19,34,47,48,37,1
02.10.2025,2025,fiba,163,Karsiyaka,Tenerife,76,87,23,23,16,23,18,19,19,22,46,39,37,41,-1
02.10.2025,2025,fiba,160,Promitheas,Nymburk,78,86,23,24,16,20,20,23,19,19,47,36,43,38,1
02.10.2025,2025,fiba,167,Murcia,Manisa,97,103,21,22,21,22,24,19,19,22,43,43,43,41,1
01.10.2025,2025,fiba,157,Oostende,Unicaja,85,92,16,24,28,22,26,18,15,28,40,50,44,43,1
01.10.2025,2025,fiba,167,Reggiana,Rytas,77,67,24,21,16,13,17,20,20,13,45,29,37,33,-1
01.10.2025,2025,fiba,149,Saint Quentin,Kolossos Rhodes,84,54,12,17,28,13,26,11,18,13,29,41,37,31,-1
01.10.2025,2025,fiba,165,Galatasaray,Vechta,103,91,30,13,26,20,22,29,25,29,43,46,51,54,1
01.10.2025,2025,fiba,161,Szczecin,Petkim Spor,70,85,16,34,11,18,22,16,21,17,50,29,38,38,-1
01.10.2025,2025,fiba,156,Wurzburg,Hapoel Holon,85,76,26,15,22,17,18,27,19,17,41,39,45,36,1
01.10.2025,2025,fiba,165,AEK Athens,Maccabi Ironi Ramat Gan,80,71,26,23,21,19,14,12,19,17,49,40,26,36,-1
01.10.2025,2025,fiba,161,VEF Riga,Bonn,86,72,19,21,22,21,17,17,28,13,40,43,34,41,-1
02.10.2025,2025,aba 2,161,Podgorica,Joker,76,79,18,26,22,22,22,11,14,20,44,44,33,34,-1
02.10.2025,2025,aba 2,164,GKK Sibenka,Zlatibor,68,73,19,22,13,16,21,15,15,20,41,29,36,35,-1
01.10.2025,2025,aba 2,153,Ilirija,Borac Banja Luka,62,70,20,16,6,17,20,19,16,18,36,23,39,34,-1
01.10.2025,2025,aba 2,154,Pelister,Siroki Brijeg,74,72,19,19,18,14,18,17,19,22,38,32,35,41,-1
26.09.2025,2025,aba 2,157,Rabotnicki,Sutjeska,58,71,16,22,5,15,15,24,22,10,38,20,39,32,-1
02.10.2025,2025,ita b,156,Libertas Livorno,Basket Torino,56,78,15,24,10,19,12,19,19,16,39,29,31,35,-1
02.10.2025,2025,ita b,159,Verona,Urania Milano,71,77,18,26,21,17,19,8,13,26,44,38,27,39,-1
02.10.2025,2025,ita b,155,Assigeco Piacenza,Rimini,87,89,25,26,23,21,22,30,17,12,51,44,52,29,1
02.10.2025,2025,ita b,149,Avellino Basket,Sebastiani Rieti,61,67,13,14,19,17,12,22,17,14,27,36,34,31,-1
02.10.2025,2025,ita b,151,Forli,Cento,75,59,21,13,18,13,20,18,16,15,34,31,38,31,-1
02.10.2025,2025,ita b,154,JuVi Cremona,Cividale,99,90,19,19,16,22,22,23,24,17,38,38,45,41,1
02.10.2025,2025,ita b,159,Pesaro,Vigevano,67,80,16,26,24,22,13,17,14,15,42,46,30,29,-1
02.10.2025,2025,ita b,150,Udine,Nardo,95,67,30,17,21,16,23,20,21,14,47,37,43,35,1
02.10.2025,2025,slovak,160,BC Prievidza,MBK Handlova,94,66,16,25,32,16,24,6,22,19,41,48,30,41,-1
02.10.2025,2025,slovak,160,Levice,Nitra Blue Wings,79,88,19,21,21,26,21,16,18,25,40,47,37,43,-1
02.10.2025,2025,slovak,164,BC Komarno,Iskra Svit,87,73,25,18,26,21,25,11,11,23,43,47,36,34,-1
02.10.2025,2025,slovak,167,Inter Bratislava,Spisski Rytieri,82,80,25,21,14,31,25,9,18,19,46,45,34,37,-1
02.10.2025,2025,slovak,165,SPU Nitra,BKM Lucenec,87,91,25,20,17,23,17,23,28,25,45,40,40,53,1
04.10.2025,2025,friendly,,Beijing Royal Fighters (Chn),Shanghai (Chn),95,91,18,28,26,24,28,19,23,20,46,50,47,43,
04.10.2025,2025,friendly,,Fujian (Chn),Beijing (Chn),63,91,15,31,14,17,21,21,13,22,46,31,42,35,
04.10.2025,2025,friendly,,Guangdong (Chn),Zhejiang Chouzhou (Chn),84,90,22,28,18,14,16,25,28,23,50,32,41,51,
04.10.2025,2025,friendly,,Jilin (Chn),Liaoning (Chn),111,109,34,38,27,23,11,19,25,17,72,50,30,42,
04.10.2025,2025,friendly,,Shenzhen (Chn),Xinjiang (Chn),95,92,25,27,20,21,27,23,23,21,52,41,50,44,
04.10.2025,2025,friendly,,Nanjing Tongxi (Chn),Sichuan (Chn),90,93,20,24,19,21,23,23,28,25,44,40,46,53,
04.10.2025,2025,friendly,,Ningbo Rockets (Chn),Shanxi Zhongyu (Chn),93,105,22,26,23,21,26,33,22,25,48,44,59,47,
04.10.2025,2025,friendly,,Jiangsu Dragons (Chn),Qingdao (Chn),75,79,16,17,28,16,13,21,18,25,33,44,34,43,
04.10.2025,2025,friendly,,Zhejiang Guangsha (Chn),Guangzhou (Chn),92,67,19,13,19,18,34,18,20,18,32,37,52,38,
04.10.2025,2025,friendly,,Shandong (Chn),Tianjin (Chn),98,95,27,26,22,21,30,24,19,24,53,43,54,43,
04.10.2025,2025,friendly,,Brasilia (Bra),Vasco (Bra),78,80,21,21,16,16,17,22,24,21,42,32,39,45,
03.10.2025,2025,friendly,,Flamengo (Bra),Minas (Bra),75,82,18,23,9,18,26,18,22,23,41,27,44,45,
03.10.2025,2025,friendly,,Caxias do Sul (Bra),Botafogo (Bra),69,64,11,17,16,13,18,21,24,13,28,29,39,37,
03.10.2025,2025,friendly,,Beijing (Chn),Zhejiang Guangsha (Chn),94,69,30,15,24,11,21,21,19,22,45,35,42,41,
03.10.2025,2025,friendly,,Liaoning (Chn),Shandong (Chn),91,83,27,13,18,31,25,22,21,17,40,49,47,38,
03.10.2025,2025,friendly,,Qingdao (Chn),Beijing Royal Fighters (Chn),67,81,19,13,20,19,14,31,14,18,32,39,45,32,
03.10.2025,2025,friendly,,Xinjiang (Chn),Shanxi Zhongyu (Chn),100,89,25,23,31,22,19,22,25,22,48,53,41,47,
03.10.2025,2025,friendly,,Zhejiang Chouzhou (Chn),Nanjing Tongxi (Chn),113,94,33,20,29,34,18,18,33,22,53,63,36,55,
03.10.2025,2025,friendly,,Shenzhen (Chn),Ningbo Rockets (Chn),81,88,15,18,23,19,23,23,20,28,33,42,46,48,
03.10.2025,2025,friendly,,Sichuan (Chn),Guangdong (Chn),83,84,19,28,23,19,25,12,16,25,47,42,37,41,
03.10.2025,2025,friendly,,Guangzhou (Chn),Fujian (Chn),92,99,19,30,19,20,26,19,28,30,49,39,45,58,
03.10.2025,2025,friendly,,Shanghai (Chn),Jiangsu Dragons (Chn),83,70,23,12,17,14,23,23,20,21,35,31,46,41,
03.10.2025,2025,friendly,,Tianjin (Chn),Jilin (Chn),87,92,23,26,17,17,21,26,26,23,49,34,47,49,
02.10.2025,2025,friendly,,Elitzur Yavne (Isr),Maccabi Rishon (Isr),80,80,15,21,22,18,22,22,21,19,36,40,44,40,
02.10.2025,2025,friendly,,KCC Egis (Kor),Anyang JungKwanJang (Kor),116,100,28,31,32,22,30,25,26,22,59,54,55,48,
02.10.2025,2025,friendly,,Botafogo (Bra),Brasilia (Bra),73,83,11,21,22,22,17,14,23,26,32,44,31,49,
01.10.2025,2025,friendly,,Vasco (Bra),Minas (Bra),92,90,23,28,25,17,25,18,19,27,51,42,43,46,
04.10.2025,2025,avst,185,Melbourne United,x,68,97,22,31,19,33,13,19,14,14,53,52,32,28,-1
04.10.2025,2025,avst,170,Tasmania JackJumpers,x,90,78,27,21,26,16,18,24,19,17,48,42,42,36,-1
03.10.2025,2025,avst,186,South East Melbourne,x,93,83,25,16,27,19,19,23,22,25,41,46,42,47,-1
04.10.2025,2025,fra,159,Le Mans,x,88,95,12,23,20,20,24,20,32,32,35,40,44,64,1
01.10.2025,2025,fra,156,Nancy,x,93,84,23,21,27,16,21,25,22,22,44,43,46,44,1
04.10.2025,2025,mac,151,Budapesti Honved Se,x,84,66,21,14,18,18,20,15,25,19,35,36,35,44,1
04.10.2025,2025,mac,174,Alba Fehervar,x,92,85,26,20,20,22,23,25,23,18,46,42,48,41,1
03.10.2025,2025,mac,164,Szolnoki Olaj,x,71,83,19,19,22,18,11,32,19,14,38,40,43,33,-1
01.10.2025,2025,mac,175,Kormend,x,114,86,33,25,30,25,32,16,19,20,58,55,48,39,-1
01.10.2025,2025,mac,158,OSE Lions,x,78,71,18,16,23,26,19,16,18,13,34,49,35,31,-1
04.10.2025,2025,pol,163,Anwil Wloclawek,x,70,97,21,25,18,25,21,23,10,24,46,43,44,34,-1
04.10.2025,2025,pol,161,Szczecin,x,72,82,18,20,24,24,21,24,9,14,38,48,45,23,-1
04.10.2025,2025,rom,163,CSM Targu Mures,x,80,75,18,18,23,17,19,18,20,22,36,40,37,42,-1
04.10.2025,2025,rom,162,Cluj-Napoca,x,87,102,21,30,17,26,23,21,26,25,51,43,44,51,1
04.10.2025,2025,rom,158,CSM Constanta,x,88,80,14,12,17,18,22,25,13,11,26,35,47,24,-1
04.10.2025,2025,swit,159,Regio Basel,x,106,59,27,15,25,13,25,13,29,18,42,38,38,47,1
01.10.2025,2025,swit,158,Fribourg Olympic,x,54,97,12,22,19,27,8,22,15,26,34,46,30,41,-1
03.10.2025,2025,bnxt,168,Kortrijk,x,80,87,18,22,24,23,20,20,18,22,40,47,40,40,-1
02.10.2025,2025,bnxt,155,BAL Weert,x,78,89,17,12,19,27,16,14,24,23,29,46,30,47,-1
02.10.2025,2025,bnxt,149,Leuven Bears,x,78,83,21,23,19,23,19,21,19,16,44,42,40,35,1
03.10.2025,2025,ger,167,Heidelberg,x,93,108,15,30,26,29,25,25,27,24,45,55,50,51,1
02.10.2025,2025,ger,160,Rostock,x,70,64,18,17,16,15,24,17,12,15,35,31,41,27,-1
30.09.2025,2025,ger,163,Ludwigsburg,x,91,71,29,14,22,23,26,12,14,22,43,45,38,36,-1
03.10.2025,2025,lat nkl,,Plunges Olimpas,x,80,49,17,8,19,4,20,13,24,24,25,23,33,48,
03.10.2025,2025,lat nkl,161,Vilkaviskis,x,93,85,25,14,24,22,20,30,24,19,39,46,50,43,1
03.10.2025,2025,lat nkl,166,Klaipedos Neptunas,x,59,81,22,14,11,18,11,26,15,23,36,29,37,38,-1
03.10.2025,2025,lat nkl,144,Zalgiris Kaunas 2,x,81,71,22,22,20,18,18,7,21,24,44,38,25,45,-1
03.10.2025,2025,lat nkl,,Silute,x,75,83,19,21,22,18,22,22,12,22,40,40,44,34,
03.10.2025,2025,lat nkl,160,Delikatesas Joniskis,x,88,74,27,13,22,20,19,16,20,25,40,42,35,45,-1
03.10.2025,2025,lat nkl,160,Jurbarkas,x,85,67,25,17,18,16,21,12,21,22,42,34,33,43,-1
03.10.2025,2025,vtb,160,Parma Perm,x,100,56,18,10,28,12,32,19,22,15,28,40,51,37,1
02.10.2025,2025,vtb,155,Samara,x,79,86,23,22,17,20,20,24,19,20,45,37,44,39,1
02.10.2025,2025,vtb,154,Uralmash Ekaterinburg,x,75,89,21,26,18,20,11,22,25,21,47,38,33,46,1
02.10.2025,2025,vtb,165,CSKA Moscow,x,48,91,18,29,12,18,12,28,6,16,47,30,40,22,-1
02.10.2025,2025,vtb,166,Lokomotiv Kuban,x,84,87,17,21,15,21,20,23,32,22,38,36,43,54,1
02.10.2025,2025,vtb,155,Unics Kazan,x,57,72,17,19,11,14,9,19,20,20,36,25,28,40,-1
03.10.2025,2025,sloven,161,Podcetrtek,x,72,67,25,14,11,21,21,9,15,23,39,32,30,38,-1
02.10.2025,2025,sloven,153,KK Krka Novo mesto,x,57,90,25,21,15,30,7,17,10,22,46,45,24,32,-1
04.10.2025,2025,ukr,,Rivne,x,67,75,16,19,14,20,19,21,18,15,35,34,40,33,
04.10.2025,2025,ukr,,Stariy Lutsk,x,63,67,11,14,17,19,15,17,20,17,25,36,32,37,
03.10.2025,2025,ukr,,Stariy Lutsk,x,89,86,10,26,27,19,14,15,26,17,36,46,29,43,
03.10.2025,2025,ukr,,Rivne,x,65,84,13,22,18,21,14,21,20,20,35,39,35,40,
02.10.2025,2025,cek,155,Slavia Prague,x,81,63,22,17,24,15,21,19,14,12,39,39,40,26,-1
02.10.2025,2025,cek,173,Srsni Pisek,x,85,97,24,22,27,34,13,27,21,14,46,61,40,35,-1
02.10.2025,2025,cek,168,Pardubice,x,57,76,14,28,15,18,11,14,17,16,42,33,25,33,-1
02.10.2025,2025,cek,173,Olomoucko,x,99,94,34,22,17,27,23,15,25,30,56,44,38,55,1
02.10.2025,2025,eurocup,170,Hamburg,x,105,78,30,29,22,15,30,21,23,13,59,37,51,36,1
02.10.2025,2025,eurocup,165,Trefl Sopot,x,84,78,25,15,19,21,17,28,23,14,40,40,45,37,-1
02.10.2025,2025,eurocup,166,Cluj-Napoca,x,84,73,24,15,18,21,26,10,16,27,39,39,36,43,-1
02.10.2025,2025,eurocup,152,Turk Telekom,x,63,68,13,21,13,15,21,11,16,21,34,28,32,37,-1
01.10.2025,2025,eurocup,163,Gran Canaria,x,86,89,25,20,19,18,14,24,23,19,45,37,38,42,-1
01.10.2025,2025,eurocup,166,Venezia,x,87,82,21,17,18,27,21,17,27,21,38,45,38,48,1
01.10.2025,2025,eurocup,169,BC Wolves,x,89,84,26,20,27,21,16,28,20,15,46,48,44,35,-1
01.10.2025,2025,eurocup,165,Joventut Badalona,x,87,83,25,17,18,19,16,16,28,31,42,37,32,59,1
01.10.2025,2025,eurocup,162,Besiktas,x,87,66,23,21,24,11,20,14,20,20,44,35,34,40,-1
01.10.2025,2025,eurocup,160,Hapoel Jerusalem,x,74,94,25,18,11,26,20,16,18,34,43,37,36,52,1
02.10.2025,2025,fiba,166,Benfica,x,92,64,31,17,21,20,27,15,13,12,48,41,42,25,-1
02.10.2025,2025,fiba,158,Chemnitz,x,87,81,22,17,25,25,21,18,19,21,39,50,39,40,-1
02.10.2025,2025,fiba,158,Peristeri,x,70,58,18,14,14,8,17,10,21,26,32,22,27,47,-1
02.10.2025,2025,fiba,155,Szombathely,x,75,84,13,22,23,16,21,21,18,25,35,39,42,43,1
02.10.2025,2025,fiba,158,Nanterre,x,86,80,19,15,20,27,29,19,18,19,34,47,48,37,1
02.10.2025,2025,fiba,163,Tenerife,x,76,87,23,23,16,23,18,19,19,22,46,39,37,41,-1
02.10.2025,2025,fiba,160,Nymburk,x,78,86,23,24,16,20,20,23,19,19,47,36,43,38,1
02.10.2025,2025,fiba,167,Manisa,x,97,103,21,22,21,22,24,19,19,22,43,43,43,41,1
01.10.2025,2025,fiba,157,Unicaja,x,85,92,16,24,28,22,26,18,15,28,40,50,44,43,1
01.10.2025,2025,fiba,167,Rytas,x,77,67,24,21,16,13,17,20,20,13,45,29,37,33,-1
01.10.2025,2025,fiba,149,Kolossos Rhodes,x,84,54,12,17,28,13,26,11,18,13,29,41,37,31,-1
01.10.2025,2025,fiba,165,Vechta,x,103,91,30,13,26,20,22,29,25,29,43,46,51,54,1
01.10.2025,2025,fiba,161,Petkim Spor,x,70,85,16,34,11,18,22,16,21,17,50,29,38,38,-1
01.10.2025,2025,fiba,156,Hapoel Holon,x,85,76,26,15,22,17,18,27,19,17,41,39,45,36,1
01.10.2025,2025,fiba,165,Maccabi Ironi Ramat Gan,x,80,71,26,23,21,19,14,12,19,17,49,40,26,36,-1
01.10.2025,2025,fiba,161,Bonn,x,86,72,19,21,22,21,17,17,28,13,40,43,34,41,-1
02.10.2025,2025,aba 2,161,Joker,x,76,79,18,26,22,22,22,11,14,20,44,44,33,34,-1
02.10.2025,2025,aba 2,164,Zlatibor,x,68,73,19,22,13,16,21,15,15,20,41,29,36,35,-1
01.10.2025,2025,aba 2,153,Borac Banja Luka,x,62,70,20,16,6,17,20,19,16,18,36,23,39,34,-1
01.10.2025,2025,aba 2,154,Siroki Brijeg,x,74,72,19,19,18,14,18,17,19,22,38,32,35,41,-1
26.09.2025,2025,aba 2,157,Sutjeska,x,58,71,16,22,5,15,15,24,22,10,38,20,39,32,-1
25.09.2025,2025,aba 2,159,Helios Domzale,x,79,87,16,21,25,18,14,21,24,27,37,43,35,51,1
02.10.2025,2025,ita b,156,Basket Torino,x,56,78,15,24,10,19,12,19,19,16,39,29,31,35,-1
02.10.2025,2025,ita b,159,Urania Milano,x,71,77,18,26,21,17,19,8,13,26,44,38,27,39,-1
02.10.2025,2025,ita b,155,Rimini,x,87,89,25,26,23,21,22,30,17,12,51,44,52,29,1
02.10.2025,2025,ita b,149,Sebastiani Rieti,x,61,67,13,14,19,17,12,22,17,14,27,36,34,31,-1
02.10.2025,2025,ita b,151,Cento,x,75,59,21,13,18,13,20,18,16,15,34,31,38,31,-1
02.10.2025,2025,ita b,154,Cividale,x,99,90,19,19,16,22,22,23,24,17,38,38,45,41,1
02.10.2025,2025,ita b,159,Vigevano,x,67,80,16,26,24,22,13,17,14,15,42,46,30,29,-1
02.10.2025,2025,ita b,150,Nardo,x,95,67,30,17,21,16,23,20,21,14,47,37,43,35,1
02.10.2025,2025,slovak,160,MBK Handlova,x,94,66,16,25,32,16,24,6,22,19,41,48,30,41,-1
02.10.2025,2025,slovak,160,Nitra Blue Wings,x,79,88,19,21,21,26,21,16,18,25,40,47,37,43,-1
02.10.2025,2025,slovak,164,Iskra Svit,x,87,73,25,18,26,21,25,11,11,23,43,47,36,34,-1
02.10.2025,2025,slovak,167,Spisski Rytieri,x,82,80,25,21,14,31,25,9,18,19,46,45,34,37,-1
02.10.2025,2025,slovak,165,BKM Lucenec,x,87,91,25,20,17,23,17,23,28,25,45,40,40,53,1
04.10.2025,2025,friendly,,Shanghai (Chn),x,95,91,18,28,26,24,28,19,23,20,46,50,47,43,
04.10.2025,2025,friendly,,Beijing (Chn),x,63,91,15,31,14,17,21,21,13,22,46,31,42,35,
04.10.2025,2025,friendly,,Zhejiang Chouzhou (Chn),x,84,90,22,28,18,14,16,25,28,23,50,32,41,51,
04.10.2025,2025,friendly,,Liaoning (Chn),x,111,109,34,38,27,23,11,19,25,17,72,50,30,42,
04.10.2025,2025,friendly,,Xinjiang (Chn),x,95,92,25,27,20,21,27,23,23,21,52,41,50,44,
04.10.2025,2025,friendly,,Sichuan (Chn),x,90,93,20,24,19,21,23,23,28,25,44,40,46,53,
04.10.2025,2025,friendly,,Shanxi Zhongyu (Chn),x,93,105,22,26,23,21,26,33,22,25,48,44,59,47,
04.10.2025,2025,friendly,,Qingdao (Chn),x,75,79,16,17,28,16,13,21,18,25,33,44,34,43,
04.10.2025,2025,friendly,,Guangzhou (Chn),x,92,67,19,13,19,18,34,18,20,18,32,37,52,38,
04.10.2025,2025,friendly,,Tianjin (Chn),x,98,95,27,26,22,21,30,24,19,24,53,43,54,43,
04.10.2025,2025,friendly,,Vasco (Bra),x,78,80,21,21,16,16,17,22,24,21,42,32,39,45,
03.10.2025,2025,friendly,,Minas (Bra),x,75,82,18,23,9,18,26,18,22,23,41,27,44,45,
03.10.2025,2025,friendly,,Botafogo (Bra),x,69,64,11,17,16,13,18,21,24,13,28,29,39,37,
03.10.2025,2025,friendly,,Zhejiang Guangsha (Chn),x,94,69,30,15,24,11,21,21,19,22,45,35,42,41,
03.10.2025,2025,friendly,,Shandong (Chn),x,91,83,27,13,18,31,25,22,21,17,40,49,47,38,
03.10.2025,2025,friendly,,Beijing Royal Fighters (Chn),x,67,81,19,13,20,19,14,31,14,18,32,39,45,32,
03.10.2025,2025,friendly,,Shanxi Zhongyu (Chn),x,100,89,25,23,31,22,19,22,25,22,48,53,41,47,
03.10.2025,2025,friendly,,Nanjing Tongxi (Chn),x,113,94,33,20,29,34,18,18,33,22,53,63,36,55,
03.10.2025,2025,friendly,,Ningbo Rockets (Chn),x,81,88,15,18,23,19,23,23,20,28,33,42,46,48,
03.10.2025,2025,friendly,,Guangdong (Chn),x,83,84,19,28,23,19,25,12,16,25,47,42,37,41,
03.10.2025,2025,friendly,,Fujian (Chn),x,92,99,19,30,19,20,26,19,28,30,49,39,45,58,
03.10.2025,2025,friendly,,Jiangsu Dragons (Chn),x,83,70,23,12,17,14,23,23,20,21,35,31,46,41,
03.10.2025,2025,friendly,,Jilin (Chn),x,87,92,23,26,17,17,21,26,26,23,49,34,47,49,
02.10.2025,2025,friendly,,Maccabi Rishon (Isr),x,80,80,15,21,22,18,22,22,21,19,36,40,44,40,
02.10.2025,2025,friendly,,Anyang JungKwanJang (Kor),x,116,100,28,31,32,22,30,25,26,22,59,54,55,48,
02.10.2025,2025,friendly,,Brasilia (Bra),x,73,83,11,21,22,22,17,14,23,26,32,44,31,49,
01.10.2025,2025,friendly,,Minas (Bra),x,92,90,23,28,25,17,25,18,19,27,51,42,43,46,
07.10.2025,2025,w nba,153,Connecticut Sun W,Minnesota Lynx W,92,82,15,22,28,28,25,13,24,19,37,56,38,43,1
06.10.2025,2025,w nba,166,Las Vegas Aces W,New York Liberty W,62,76,19,23,19,18,13,12,11,23,42,37,25,34,-1
05.10.2025,2025,w nba,165,Las Vegas Aces W,New York Liberty W,95,81,26,23,26,26,21,6,22,26,49,52,27,48,-1
05.10.2025,2025,w nba,151,Connecticut Sun W,Minnesota Lynx W,81,90,16,23,20,25,18,20,27,22,39,45,38,49,1
02.10.2025,2025,w nba,153,Minnesota Lynx W,Connecticut Sun W,77,70,12,10,24,20,22,19,19,21,22,44,41,40,1
02.10.2025,2025,w nba,163,New York Liberty W,Las Vegas Aces W,88,84,22,27,24,13,23,22,19,22,49,37,45,41,1
30.09.2025,2025,w nba,152,Minnesota Lynx W,Connecticut Sun W,70,73,16,23,22,19,24,15,8,16,39,41,39,24,-1
29.09.2025,2025,w nba,162,New York Liberty W,Las Vegas Aces W,87,77,28,21,20,17,23,24,16,15,49,37,47,31,-1
26.09.2025,2025,w nba,160,Minnesota Lynx W,Phoenix Mercury W,101,88,21,25,28,22,27,17,25,24,46,50,44,49,1
26.09.2025,2025,w nba,163,Connecticut Sun W,Indiana Fever W,87,81,17,14,24,20,20,18,26,29,31,44,38,55,1
25.09.2025,2025,w nba,159,Las Vegas Aces W,Seattle Storm W,83,76,30,20,15,18,17,19,21,19,50,33,36,40,-1
25.09.2025,2025,w nba,155,New York Liberty W,Atlanta Dream W,91,82,19,28,24,20,22,16,26,18,47,44,38,44,1
23.09.2025,2025,w nba,161,Las Vegas Aces W,Seattle Storm W,78,67,9,18,29,24,26,23,14,2,27,53,49,16,-1
23.09.2025,2025,w nba,158,Minnesota Lynx W,Phoenix Mercury W,102,95,32,19,24,23,21,27,25,26,51,47,48,51,1
22.09.2025,2025,w nba,164,Connecticut Sun W,Indiana Fever W,93,69,23,20,23,18,22,19,25,12,43,41,41,37,-1
22.09.2025,2025,w nba,157,New York Liberty W,Atlanta Dream W,83,69,29,16,19,14,21,19,14,20,45,33,40,34,-1
06.10.2025,2025,bul,159,Balkan,Beroe,91,92,16,25,27,20,33,20,15,27,41,47,53,42,1
05.10.2025,2025,bul,163,Rilski Sportist,Spartak Pleven,99,81,32,20,23,15,24,23,20,23,52,38,47,43,1
04.10.2025,2025,bul,164,Shumen,Minyor,74,90,23,23,8,24,19,26,24,17,46,32,45,41,1
06.10.2025,2025,avst,174,Tasmania JackJumpers,Perth,84,79,9,23,21,13,17,17,24,18,32,34,34,42,-1
06.10.2025,2025,avst,179,Melbourne United,Cairns Taipans,88,101,27,23,27,35,17,22,17,21,50,62,39,38,-1
05.10.2025,2025,avst,186,Brisbane Bullets,Sydney,82,91,17,22,10,25,28,28,27,16,39,35,56,43,1
05.10.2025,2025,avst,189,Illawarra Hawks,Adelaide,100,102,32,27,22,25,27,29,19,21,59,47,56,40,1
06.10.2025,2025,aba,166,Partizan,Cibona,113,78,34,20,29,27,28,19,22,12,54,56,47,34,-1
06.10.2025,2025,aba,160,Split,Crvena zvezda,85,78,18,16,19,23,23,22,25,17,34,42,45,42,1
06.10.2025,2025,aba,157,FMP Beograd,Borac,74,67,19,22,19,12,20,20,16,13,41,31,40,29,-1
05.10.2025,2025,aba,161,KK Krka Novo mesto,Subotica,87,89,20,15,28,24,27,24,12,26,35,52,51,38,1
05.10.2025,2025,aba,158,Igokea,Buducnost,71,76,15,20,12,22,18,14,26,20,35,34,32,46,-1
05.10.2025,2025,aba,170,Dubai,Mega Basket,80,83,24,18,21,18,18,24,17,23,42,39,42,40,-1
05.10.2025,2025,aba,165,Mornar Bar,Cedevita Olimpija,82,92,23,25,20,21,18,27,21,19,48,41,45,40,1
01.10.2025,2025,aba,160,Cibona,Studentski Centar,75,69,12,17,28,17,22,19,13,16,29,45,41,29,-1
30.09.2025,2025,aba,157,Borac,KK Krka Novo mesto,80,71,17,17,20,23,22,18,21,13,34,43,40,34,-1
06.10.2025,2025,aus,160,Swans Gmunden,St. Polten,83,76,24,18,20,16,18,18,21,24,42,36,36,45,1
06.10.2025,2025,aus,150,Furstenfeld,Traiskirchen Lions,58,86,13,18,12,17,23,26,10,25,31,29,49,35,1
05.10.2025,2025,aus,158,BBC Nord,Klosterneuburg Dukes,75,78,21,23,12,10,19,22,23,23,44,22,41,46,1
05.10.2025,2025,aus,155,Oberwart Gunners,Kapfenberg Bulls,102,97,20,26,19,19,22,14,20,22,46,38,36,42,1
06.10.2025,2025,cro,161,Dubrava,Dinamo Zagreb,70,80,20,18,21,17,13,25,16,20,38,38,38,36,-1
05.10.2025,2025,cro,160,Osijek,GKK Sibenka,78,89,18,31,12,22,26,19,22,17,49,34,45,39,1
05.10.2025,2025,cro,161,Kvarner,Alkar,81,64,20,13,23,18,16,14,22,19,33,41,30,41,-1
04.10.2025,2025,cro,161,Cibona,Cedevita Junior,68,75,16,19,19,18,20,18,13,20,35,37,38,33,-1
04.10.2025,2025,cro,159,Zabok,Zadar,54,85,9,20,18,22,16,22,11,21,29,40,38,32,-1
04.10.2025,2025,cro,161,Split,Dubrovnik,90,59,23,9,29,14,22,26,16,10,32,43,48,26,-1
04.10.2025,2025,cro,165,Dinamo Zagreb,Zabok,96,99,17,16,23,20,18,22,27,27,33,43,40,54,1
06.10.2025,2025,cek,156,Usti n. Labem,Brno,75,76,21,20,17,22,19,16,18,18,41,39,35,36,-1
06.10.2025,2025,cek,177,Srsni Pisek,Jindrichuv Hradec,109,53,26,11,27,16,25,13,31,13,37,43,38,44,-1
05.10.2025,2025,cek,165,Olomoucko,USK Prague,80,88,16,27,24,21,15,11,25,29,43,45,26,54,-1
05.10.2025,2025,cek,169,Opava,NH Ostrava,92,78,21,16,25,24,27,18,19,20,37,49,45,39,-1
05.10.2025,2025,cek,166,Pardubice,Nymburk,89,94,28,20,23,21,28,21,10,32,48,44,49,42,1
05.10.2025,2025,cek,160,Slavia Prague,Decin,83,71,29,23,15,19,20,15,19,14,52,34,35,33,-1
06.10.2025,2025,lat-st,153,BC Kalev/Cramo,Latvijas Universitate,81,76,21,18,16,20,26,23,18,15,39,36,49,33,1
05.10.2025,2025,lat-st,160,BK Liepaja,Rigas Zelli,78,82,20,22,19,21,24,18,15,21,42,40,42,36,-1
05.10.2025,2025,lat-st,165,BK Ogre,Ventspils,95,75,21,13,26,17,24,21,24,24,34,43,45,48,1
04.10.2025,2025,lat-st,160,Valmiera Glass Via,VEF Riga,61,68,18,18,19,21,10,14,14,15,36,40,24,29,-1
06.10.2025,2025,fra,159,Lyon-Villeurbanne,Monaco,88,71,21,16,25,20,20,17,22,18,37,45,37,40,-1
06.10.2025,2025,fra,156,Paris,La Rochelle,84,75,23,21,23,20,17,14,21,20,44,43,31,41,-1
06.10.2025,2025,fra,153,Saint Quentin,Nancy,104,96,24,25,22,18,29,32,29,21,49,40,61,50,1
05.10.2025,2025,fra,149,Cholet,Gravelines-Dunkerque,106,74,26,21,25,15,31,17,24,21,47,40,48,45,1
05.10.2025,2025,fra,158,Le Portel,Chalon/Saone,87,81,26,23,20,21,19,20,22,17,49,41,39,39,-1
05.10.2025,2025,fra,156,Limoges,Dijon,87,73,15,22,20,13,25,19,27,19,37,33,44,46,1
05.10.2025,2025,fra,165,Nanterre,JL Bourg,61,86,16,23,19,23,18,17,8,23,39,42,35,31,-1
06.10.2025,2025,ger,164,Chemnitz,Vechta,88,77,24,16,20,18,21,17,23,26,40,38,38,49,1
06.10.2025,2025,ger,174,Hamburg,Oldenburg,87,78,21,23,20,20,19,21,27,14,44,40,40,41,-1
06.10.2025,2025,ger,169,Bonn,Alba Berlin,91,87,22,23,24,21,24,22,21,21,45,45,46,42,1
06.10.2025,2025,ger,161,Frankfurt,Syntainics MBC,69,79,15,14,13,25,25,21,16,19,29,38,46,35,1
06.10.2025,2025,ger,166,Gottingen,Bayern,81,95,21,24,24,19,17,31,19,21,45,43,48,40,1
05.10.2025,2025,ger,172,Basketball Braunschweig,Heidelberg,65,72,15,19,16,19,17,13,17,21,34,35,30,38,-1
05.10.2025,2025,ger,164,Ulm,Ludwigsburg,63,62,12,19,22,18,15,7,14,18,31,40,22,32,-1
05.10.2025,2025,ger,159,Rostock,Wurzburg,65,92,15,23,12,24,6,26,32,19,38,36,32,51,1
03.10.2025,2025,ger,166,Syntainics MBC,Heidelberg,93,108,15,30,26,29,25,25,27,24,45,55,50,51,1
06.10.2025,2025,ger b,161,Kirchheim,Bochum,70,63,18,12,17,18,14,15,21,18,30,35,29,39,-1
06.10.2025,2025,ger b,155,Trier,Koblenz,80,62,24,15,14,14,19,12,23,21,39,28,31,44,-1
06.10.2025,2025,ger b,168,Dresden,Artland,96,109,25,34,31,26,18,25,22,24,59,57,43,46,1
06.10.2025,2025,ger b,157,Nurnberger,Tubingen,77,79,23,21,22,15,15,25,17,18,44,37,40,35,-1
05.10.2025,2025,ger b,160,Munster,Giessen,91,90,30,22,16,24,27,27,18,17,52,40,54,35,1
05.10.2025,2025,ger b,166,PS Karlsruhe,Vechta 2,95,71,29,18,25,15,21,18,20,20,47,40,39,40,-1
05.10.2025,2025,ger b,175,Bayreuth,Phoenix Hagen,78,103,11,30,26,30,24,18,17,25,41,56,42,42,-1
05.10.2025,2025,ger b,158,Dusseldorf,Jena,69,96,19,22,16,27,18,25,16,22,41,43,43,38,1
05.10.2025,2025,ger b,171,Bremerhaven,Crailsheim Merlins,85,94,18,23,22,18,19,30,26,23,41,40,49,49,1
06.10.2025,2025,greek,154,Panionios,Kolossos Rhodes,67,65,13,20,12,17,22,14,20,14,33,29,36,34,-1
06.10.2025,2025,greek,157,AS Karditsas,Panathinaikos,66,80,14,21,17,21,19,17,16,21,35,38,36,37,-1
05.10.2025,2025,greek,155,Peristeri,PAOK,72,80,20,18,17,28,18,23,17,11,38,45,41,28,-1
05.10.2025,2025,greek,166,Maroussi,Promitheas,80,84,22,14,24,26,13,23,21,21,36,50,36,42,-1
05.10.2025,2025,greek,153,Aris,AEK Athens,59,70,17,14,12,12,12,18,18,26,31,24,30,44,-1
06.10.2025,2025,isr,162,Nes Ziona,Hapoel Jerusalem,74,81,19,13,14,27,20,18,21,23,32,41,38,44,1
06.10.2025,2025,isr,163,Galil Elyon,Bnei Herzliya,87,93,27,23,13,29,25,20,22,21,50,42,45,43,1
06.10.2025,2025,isr,162,Ironi Kiryat Ata,H. Afula,67,84,20,22,16,21,12,30,19,11,42,37,42,30,-1
06.10.2025,2025,ita,166,Virtus Bologna,Pistoia,84,68,32,19,19,20,17,10,16,19,51,39,27,35,-1
06.10.2025,2025,ita,157,Cremona,Reggiana,74,77,19,13,17,20,22,17,9,17,32,37,39,26,-1
06.10.2025,2025,ita,156,Olimpia Milano,Sassari,100,75,23,14,34,17,19,23,24,21,37,51,42,45,1
06.10.2025,2025,ita,168,Basket Napoli,Trieste,83,92,24,20,22,22,21,29,16,21,44,44,50,37,1
06.10.2025,2025,ita,171,Scafati,Brescia,93,95,24,21,20,14,23,33,26,27,45,34,56,53,1
06.10.2025,2025,ita,173,Varese,Tortona,95,105,28,29,32,22,13,31,22,23,57,54,44,45,1
05.10.2025,2025,ita,167,Treviso,Trapani,71,87,19,21,22,18,12,23,18,25,40,40,35,43,-1
05.10.2025,2025,ita,164,Trento,Venezia,82,70,17,21,22,20,25,15,18,14,38,42,40,32,-1
06.10.2025,2025,ita b,150,Forli,Verona,92,86,21,17,19,23,16,21,16,11,38,42,37,27,-1
06.10.2025,2025,ita b,153,Basket Torino,Udine,58,84,18,19,15,22,19,22,6,21,37,37,41,27,-1
06.10.2025,2025,ita b,154,Cento,Orzinuovi,84,86,22,18,16,21,27,22,19,25,40,37,49,44,1
06.10.2025,2025,ita b,152,Pesaro,Avellino Basket,82,77,21,22,17,12,22,22,22,21,43,29,44,43,1
06.10.2025,2025,ita b,153,Rimini,Fortitudo Bologna,74,66,16,17,12,20,22,12,24,17,33,32,34,41,-1
06.10.2025,2025,ita b,150,Vigevano,Libertas Livorno,66,76,22,23,19,13,16,23,9,17,45,32,39,26,-1
06.10.2025,2025,ita b,159,Nardo,JuVi Cremona,72,97,15,14,15,26,27,26,15,31,29,41,53,46,1
06.10.2025,2025,ita b,150,Sebastiani Rieti,Cantu,68,74,20,18,9,18,27,18,12,20,38,27,45,32,1
05.10.2025,2025,ita b,161,Urania Milano,Assigeco Piacenza,86,73,20,27,28,17,18,16,20,13,47,45,34,33,-1
06.10.2025,2025,lat lkl,164,Juventus,Neptunas,92,99,17,32,29,24,27,21,19,22,49,53,48,41,1
06.10.2025,2025,lat lkl,164,Rytas,Zalgiris Kaunas,91,88,22,18,28,17,23,25,18,28,40,45,48,46,1
05.10.2025,2025,lat lkl,174,Jonava,Siauliai,104,93,23,25,29,27,28,13,24,28,48,56,41,52,1
05.10.2025,2025,lat lkl,164,Mazeikiai,BC Wolves,86,95,26,25,26,25,13,24,21,21,51,51,37,42,-1
05.10.2025,2025,lat lkl,165,Nevezis,Lietkabelis,78,85,30,19,15,21,17,18,16,27,49,36,35,43,-1
06.10.2025,2025,mak,,Cair 2030,Kozuv,99,79,20,28,20,13,30,18,29,20,48,33,48,49,
06.10.2025,2025,mak,,Tikvesh,Pelister,84,96,21,23,16,26,20,27,27,20,44,42,47,47,
06.10.2025,2025,mak,,Vardar,Gostivar,70,76,14,21,25,21,18,17,13,17,35,46,35,30,
05.10.2025,2025,mak,,Rabotnicki,Feniks 2010,90,85,33,19,8,35,25,14,24,17,52,43,39,41,
05.10.2025,2025,mak,,Shkupi Skopje,MZT Skopje,59,95,18,20,9,22,18,22,14,31,38,31,40,45,
05.10.2025,2025,mak,,TFT Skopje,MKK Kumanovo,81,70,20,20,15,17,23,20,23,13,40,32,43,36,
06.10.2025,2025,pol,157,Czarni Slupsk,Spojnia Stargard,71,79,22,18,12,21,23,21,14,19,40,33,44,33,-1
06.10.2025,2025,pol,165,Legia,Dabrowa Gornicza,68,77,21,19,16,27,20,16,11,15,40,43,36,26,-1
06.10.2025,2025,pol,162,GTK Gliwice,Slask Wroclaw,91,73,21,19,25,13,20,24,25,17,40,38,44,42,1
05.10.2025,2025,pol,172,Torun,Lublin,90,96,21,22,23,26,21,24,25,24,43,49,45,49,1
05.10.2025,2025,pol,170,Gdynia,Trefl Sopot,89,97,14,34,24,27,23,21,28,15,48,51,44,43,1
05.10.2025,2025,pol,159,Dziki Warszawa,Ostrow Wielkopolski,88,63,23,14,17,17,13,21,35,11,37,34,34,46,1
04.10.2025,2025,pol,163,Zielona Gora,Anwil Wloclawek,70,97,21,25,18,25,21,23,10,24,46,43,44,34,-1
04.10.2025,2025,pol,161,Gornik Walbrzych,Szczecin,72,82,18,20,24,24,21,24,9,14,38,48,45,23,-1
06.10.2025,2025,vtb,152,Samara,Enisey,83,65,12,21,33,6,20,13,18,25,33,39,33,43,-1
06.10.2025,2025,vtb,175,Zenit Petersburg,Lokomotiv Kuban,76,83,15,17,19,15,20,23,22,28,32,34,43,50,1
06.10.2025,2025,vtb,149,Parma Perm,MBA Moscow,83,54,19,5,22,15,23,17,19,17,24,37,40,36,1
06.10.2025,2025,vtb,157,Uralmash Ekaterinburg,Unics Kazan,65,87,16,27,21,15,6,27,22,18,43,36,33,40,-1
06.10.2025,2025,vtb,156,Astana,Saratov,52,74,14,20,14,17,14,23,10,14,34,31,37,24,-1
05.10.2025,2025,vtb,156,Nizhny Novgorod,CSKA Moscow,77,75,18,19,10,18,24,20,25,18,37,28,44,43,1
06.10.2025,2025,sırbistan,168,Joker,Mladost Zemun,72,78,17,24,18,12,18,16,19,26,41,30,34,45,-1
06.10.2025,2025,sırbistan,162,OKK Novi Pazar,Radnicki,78,84,20,17,15,23,18,22,25,22,37,38,40,47,1
06.10.2025,2025,sırbistan,166,Zlatibor,Sloboda,75,57,24,19,20,13,22,12,9,13,43,33,34,22,-1
06.10.2025,2025,sırbistan,166,OKK Beograd,Sloga,95,86,29,13,26,25,22,28,18,20,42,51,50,38,1
05.10.2025,2025,sırbistan,163,Cacak 94,Vrsac,76,77,25,17,13,18,19,24,19,18,42,31,43,37,-1
05.10.2025,2025,sırbistan,165,Tamis,KK Metalac,85,84,27,19,20,24,20,26,18,15,46,44,46,33,-1
05.10.2025,2025,sırbistan,160,Dynamic,BBK Radnicki,75,82,18,29,13,18,17,17,27,18,47,31,34,45,-1
04.10.2025,2025,sırbistan,157,KK Mladost SP,Vojvodina Novi Sad,64,80,14,22,16,20,12,23,22,15,36,36,35,37,-1
06.10.2025,2025,tur,170,Fenerbahce,Buyukcekmece,97,85,16,18,33,26,16,18,32,23,34,59,34,55,1
06.10.2025,2025,tur,165,Anadolu Efes,Yalovaspor,100,59,29,13,31,12,21,15,19,19,42,43,36,38,-1
06.10.2025,2025,tur,169,Petkim Spor,Darussafaka,108,85,22,28,31,12,34,19,21,26,50,43,53,47,1
06.10.2025,2025,tur,163,Bahcesehir Kol.,Karsiyaka,82,68,23,18,29,24,12,10,18,16,41,53,22,34,-1
05.10.2025,2025,tur,165,Tofas,Besiktas,99,95,30,30,24,20,19,23,26,22,60,44,42,48,1
05.10.2025,2025,tur,162,Turk Telekom,Galatasaray,72,70,11,22,18,22,20,13,23,13,33,40,33,36,-1
05.10.2025,2025,tur,173,Manisa,Bursaspor,73,81,19,22,12,19,22,15,20,25,41,31,37,45,-1
04.10.2025,2025,tur,166,Merkezefendi,Mersin BŞB,65,75,20,21,13,21,13,16,19,17,41,34,29,36,-1
06.10.2025,2025,tur b,160,MKE Ankaragucu,Harem Spor,86,75,24,24,22,16,19,24,21,11,48,38,43,32,-1
06.10.2025,2025,tur b,162,Esenler Erokspor,Gaziantep,75,82,25,15,19,18,10,22,21,27,40,37,32,48,-1
06.10.2025,2025,tur b,163,Konya BBSK,Trabzonspor,84,80,24,15,21,6,24,32,15,27,39,27,56,42,1
05.10.2025,2025,tur b,156,Cayirova,OGM Ormanspor,86,79,22,20,27,14,17,16,20,29,42,41,33,49,1
05.10.2025,2025,tur b,154,Bordo Sportif,Çağdaş Bodrum Spor,81,64,27,15,24,13,14,14,16,22,42,37,28,38,-1
05.10.2025,2025,tur b,148,Ankara Kolejliler,Balikesir,84,73,25,17,19,19,17,13,23,24,42,38,30,47,1
05.10.2025,2025,tur b,153,Istanbul Anka Spor,CO Basket,73,81,22,21,23,21,13,25,15,14,43,44,38,29,-1
04.10.2025,2025,tur b,159,iLab Basketbol,Fenerbahce 2,67,57,21,11,14,15,17,18,15,13,32,29,35,28,-1
06.10.2025,2025,ukr,,BK Zaporozhye,Kryvbas,46,69,11,18,12,24,7,12,16,15,29,36,19,31,
06.10.2025,2025,ukr,,BC Dnipro,Cherkaski Mavpy,82,63,27,19,10,12,23,11,22,21,46,22,34,43,
05.10.2025,2025,ukr,,BK Zaporozhye,Cherkaski Mavpy,80,90,27,28,18,28,16,15,19,19,55,46,31,38,
05.10.2025,2025,ukr,,BC Dnipro,Kryvbas,83,48,21,18,29,5,19,7,14,18,39,34,26,32,
04.10.2025,2025,ukr,,Kyiv Basket,Rivne,67,75,16,19,14,20,19,21,18,15,35,34,40,33,
04.10.2025,2025,ukr,,Goverla,Stariy Lutsk,63,67,11,14,17,19,15,17,20,17,25,36,32,37,
04.10.2025,2025,ukr,,Kyiv Basket,Stariy Lutsk,89,86,10,26,27,19,14,15,26,17,36,46,29,43,
06.10.2025,2025,mak,,Cair 2030,Kozuv,99,79,20,28,20,13,30,18,29,20,48,33,48,49,
06.10.2025,2025,mak,,Tikvesh,Pelister,84,96,21,23,16,26,20,27,27,20,44,42,47,47,
06.10.2025,2025,mak,,Vardar,Gostivar,70,76,14,21,25,21,18,17,13,17,35,46,35,30,
05.10.2025,2025,mak,,Rabotnicki,Feniks 2010,90,85,33,19,8,35,25,14,24,17,52,43,39,41,
05.10.2025,2025,mak,,Shkupi Skopje,MZT Skopje,59,95,18,20,9,22,18,22,14,31,38,31,40,45,
05.10.2025,2025,mak,,TFT Skopje,MKK Kumanovo,81,70,20,20,15,17,23,20,23,13,40,32,43,36,
08.10.2025,2025,kore,171,Wonju DB,Seoul Knights,75,84,15,27,24,16,24,21,12,20,42,40,45,32,-1
08.10.2025,2025,kore,163,LG Sakers,Suwon KT,65,76,13,18,17,19,22,19,13,20,31,36,41,33,-1
07.10.2025,2025,kore,168,KoGas,Sangmu,76,64,19,16,15,15,19,21,23,12,35,30,40,35,-1
07.10.2025,2025,kore,171,Anyang JungKwanJang,Goyang Sono,77,83,18,22,14,23,27,18,18,20,40,37,45,38,-1
06.10.2025,2025,kore,167,Seoul Knights,Wonju DB,81,107,20,28,15,29,30,28,16,22,48,44,58,38,1
06.10.2025,2025,kore,173,Suwon KT,KCC Egis,84,74,25,14,27,16,18,29,14,15,39,43,47,29,-1
05.10.2025,2025,kore,172,Goyang Sono,Mobis Phoebus,74,90,21,18,17,20,15,33,21,19,39,37,48,40,1
05.10.2025,2025,kore,173,Sangmu,Seoul Thunders,80,87,19,27,11,19,28,17,22,24,46,30,45,46,1
07.10.2025,2025,rom,151,CSU Sibiu,SCM Craiova,80,67,22,20,24,13,11,12,23,22,42,37,23,45,-1
07.10.2025,2025,rom,166,Dinamo Bucharest,Municipal Galati,103,88,24,24,23,21,19,16,37,27,48,44,35,64,1
05.10.2025,2025,rom,163,CSM Constanta,Valcea,55,92,13,21,19,30,8,23,15,18,34,49,31,33,-1
05.10.2025,2025,rom,150,Arges Pitesti,BC Steaua Bucuresti,77,83,16,18,17,20,23,25,21,20,34,37,48,41,1
05.10.2025,2025,rom,156,CSM Oradea,Petrolul Ploiesti,82,66,20,15,20,11,20,23,22,17,35,31,43,39,1
05.10.2025,2025,rom,154,Rapid Bucuresti,BC Timisoara,78,76,22,10,20,25,17,22,19,19,32,45,39,38,-1
27.09.2025,2025,fiba euro,161,Dijon,Dinamo Zagreb,105,57,28,20,22,16,30,12,25,9,48,38,42,34,-1
27.09.2025,2025,fiba euro,154,Sporting CP,Spirou Charleroi,79,72,23,18,14,15,27,21,15,18,41,29,48,33,1
27.09.2025,2025,fiba euro,159,Bilbao,Neptunas,95,59,18,24,29,12,26,15,22,8,42,41,41,30,-1
27.09.2025,2025,fiba euro,156,Anorthosis,Starlites,87,75,26,9,25,27,20,22,16,17,35,52,42,33,-1
27.09.2025,2025,fiba euro,172,Alba Fehervar,BC Prievidza,104,84,31,31,28,14,27,16,18,23,62,42,43,41,-1
26.09.2025,2025,fiba euro,155,BC Dnipro,CSM Constanta,71,84,18,30,18,17,13,23,22,14,48,35,36,36,-1
26.09.2025,2025,fiba euro,169,Peja,Maroussi,81,106,28,22,25,28,13,32,15,24,50,53,45,39,-1
24.09.2025,2025,fiba euro,155,Spirou Charleroi,Sporting CP,69,69,18,22,15,18,18,18,18,11,40,33,36,29,-1
24.09.2025,2025,fiba euro,156,Starlites,Anorthosis,74,81,18,22,24,27,19,21,13,11,40,51,40,24,-1
24.09.2025,2025,fiba euro,162,CSM Constanta,BC Dnipro,69,71,15,17,16,13,15,18,23,23,32,29,33,46,-1
24.09.2025,2025,fiba euro,156,Dinamo Zagreb,Dijon,84,95,24,24,18,23,21,26,21,22,48,41,47,43,1
24.09.2025,2025,fiba euro,169,Maroussi,Peja,98,75,34,20,20,23,20,15,24,17,54,43,35,41,-1
24.09.2025,2025,fiba euro,165,BC Prievidza,Alba Fehervar,102,85,23,18,26,24,25,21,28,22,41,50,46,50,1
24.09.2025,2025,fiba euro,160,Neptunas,Bilbao,66,74,19,21,12,16,15,16,20,21,40,28,31,41,-1
04.10.2025,2025,fin,171,Honka,KTP Kotka Basket,94,87,23,16,13,28,20,15,23,20,39,41,35,43,-1
04.10.2025,2025,fin,162,BC Nokia,Karhu Basket,71,79,20,22,20,23,18,16,13,18,42,43,34,31,-1
04.10.2025,2025,fin,165,Bisons Loimaa,UU-Korihait Uusikaupunki,74,86,17,21,20,26,18,11,19,28,38,46,29,47,-1
04.10.2025,2025,fin,167,Helsinki Seagulls,Salon Vilpas,94,85,22,32,29,22,19,15,24,16,54,51,34,40,-1
04.10.2025,2025,fin,165,Kobrat,Kouvot Kouvola,76,89,18,21,18,20,22,32,18,16,39,38,54,34,1
04.10.2025,2025,fin,164,Pyrinto Tampere,Kataja,66,100,12,30,17,30,22,18,15,22,42,47,40,37,-1
05.10.2025,2025,bnxt,157,Mechelen,Zwolle,92,69,28,18,17,16,23,22,24,13,46,33,45,37,1
05.10.2025,2025,bnxt,151,Okapi Aalst,Donar Groningen,93,91,19,17,19,22,30,24,25,28,36,41,54,53,1
05.10.2025,2025,bnxt,152,BAL Weert,Den Helder,80,74,29,28,23,14,11,15,17,17,57,37,26,34,-1
05.10.2025,2025,bnxt,148,Leiden,Limburg,66,86,23,24,16,19,14,23,13,20,47,35,37,33,-1
05.10.2025,2025,bnxt,159,LWD Basket,Oostende,86,92,19,18,18,28,22,18,27,28,37,46,40,55,1
05.10.2025,2025,bnxt,159,Feyenoord,Belfius Mons,71,84,18,25,17,19,14,21,22,19,43,36,35,41,-1
07.10.2025,2025,w nba,153,Minnesota Lynx W,x,92,82,15,22,28,28,25,13,24,19,37,56,38,43,1
06.10.2025,2025,w nba,166,New York Liberty W,x,62,76,19,23,19,18,13,12,11,23,42,37,25,34,-1
05.10.2025,2025,w nba,165,New York Liberty W,x,95,81,26,23,26,26,21,6,22,26,49,52,27,48,-1
05.10.2025,2025,w nba,151,Minnesota Lynx W,x,81,90,16,23,20,25,18,20,27,22,39,45,38,49,1
02.10.2025,2025,w nba,153,Connecticut Sun W,x,77,70,12,10,24,20,22,19,19,21,22,44,41,40,1
02.10.2025,2025,w nba,163,Las Vegas Aces W,x,88,84,22,27,24,13,23,22,19,22,49,37,45,41,1
30.09.2025,2025,w nba,152,Connecticut Sun W,x,70,73,16,23,22,19,24,15,8,16,39,41,39,24,-1
29.09.2025,2025,w nba,162,Las Vegas Aces W,x,87,77,28,21,20,17,23,24,16,15,49,37,47,31,-1
26.09.2025,2025,w nba,160,Phoenix Mercury W,x,101,88,21,25,28,22,27,17,25,24,46,50,44,49,1
26.09.2025,2025,w nba,163,Indiana Fever W,x,87,81,17,14,24,20,20,18,26,29,31,44,38,55,1
25.09.2025,2025,w nba,159,Seattle Storm W,x,83,76,30,20,15,18,17,19,21,19,50,33,36,40,-1
25.09.2025,2025,w nba,155,Atlanta Dream W,x,91,82,19,28,24,20,22,16,26,18,47,44,38,44,1
23.09.2025,2025,w nba,161,Seattle Storm W,x,78,67,9,18,29,24,26,23,14,2,27,53,49,16,-1
23.09.2025,2025,w nba,158,Phoenix Mercury W,x,102,95,32,19,24,23,21,27,25,26,51,47,48,51,1
22.09.2025,2025,w nba,164,Indiana Fever W,x,93,69,23,20,23,18,22,19,25,12,43,41,41,37,-1
22.09.2025,2025,w nba,157,Atlanta Dream W,x,83,69,29,16,19,14,21,19,14,20,45,33,40,34,-1
06.10.2025,2025,bul,159,Beroe,x,91,92,16,25,27,20,33,20,15,27,41,47,53,42,1
05.10.2025,2025,bul,163,Spartak Pleven,x,99,81,32,20,23,15,24,23,20,23,52,38,47,43,1
04.10.2025,2025,bul,164,Minyor,x,74,90,23,23,8,24,19,26,24,17,46,32,45,41,1
06.10.2025,2025,avst,174,Perth,x,84,79,9,23,21,13,17,17,24,18,32,34,34,42,-1
06.10.2025,2025,avst,179,Cairns Taipans,x,88,101,27,23,27,35,17,22,17,21,50,62,39,38,-1
05.10.2025,2025,avst,186,Sydney,x,82,91,17,22,10,25,28,28,27,16,39,35,56,43,1
05.10.2025,2025,avst,189,Adelaide,x,100,102,32,27,22,25,27,29,19,21,59,47,56,40,1
06.10.2025,2025,aba,166,Cibona,x,113,78,34,20,29,27,28,19,22,12,54,56,47,34,-1
06.10.2025,2025,aba,160,Crvena zvezda,x,85,78,18,16,19,23,23,22,25,17,34,42,45,42,1
06.10.2025,2025,aba,157,Borac,x,74,67,19,22,19,12,20,20,16,13,41,31,40,29,-1
05.10.2025,2025,aba,161,Subotica,x,87,89,20,15,28,24,27,24,12,26,35,52,51,38,1
05.10.2025,2025,aba,158,Buducnost,x,71,76,15,20,12,22,18,14,26,20,35,34,32,46,-1
05.10.2025,2025,aba,170,Mega Basket,x,80,83,24,18,21,18,18,24,17,23,42,39,42,40,-1
05.10.2025,2025,aba,165,Cedevita Olimpija,x,82,92,23,25,20,21,18,27,21,19,48,41,45,40,1
01.10.2025,2025,aba,160,Studentski Centar,x,75,69,12,17,28,17,22,19,13,16,29,45,41,29,-1
30.09.2025,2025,aba,157,KK Krka Novo mesto,x,80,71,17,17,20,23,22,18,21,13,34,43,40,34,-1
06.10.2025,2025,aus,160,St. Polten,x,83,76,24,18,20,16,18,18,21,24,42,36,36,45,1
06.10.2025,2025,aus,150,Traiskirchen Lions,x,58,86,13,18,12,17,23,26,10,25,31,29,49,35,1
05.10.2025,2025,aus,158,Klosterneuburg Dukes,x,75,78,21,23,12,10,19,22,23,23,44,22,41,46,1
05.10.2025,2025,aus,155,Kapfenberg Bulls,x,102,97,20,26,19,19,22,14,20,22,46,38,36,42,1
06.10.2025,2025,cro,161,Dinamo Zagreb,x,70,80,20,18,21,17,13,25,16,20,38,38,38,36,-1
05.10.2025,2025,cro,160,GKK Sibenka,x,78,89,18,31,12,22,26,19,22,17,49,34,45,39,1
05.10.2025,2025,cro,161,Alkar,x,81,64,20,13,23,18,16,14,22,19,33,41,30,41,-1
04.10.2025,2025,cro,161,Cedevita Junior,x,68,75,16,19,19,18,20,18,13,20,35,37,38,33,-1
04.10.2025,2025,cro,159,Zadar,x,54,85,9,20,18,22,16,22,11,21,29,40,38,32,-1
04.10.2025,2025,cro,161,Dubrovnik,x,90,59,23,9,29,14,22,26,16,10,32,43,48,26,-1
04.10.2025,2025,cro,165,Zabok,x,96,99,17,16,23,20,18,22,27,27,33,43,40,54,1
06.10.2025,2025,cek,156,Brno,x,75,76,21,20,17,22,19,16,18,18,41,39,35,36,-1
06.10.2025,2025,cek,177,Jindrichuv Hradec,x,109,53,26,11,27,16,25,13,31,13,37,43,38,44,-1
05.10.2025,2025,cek,165,USK Prague,x,80,88,16,27,24,21,15,11,25,29,43,45,26,54,-1
05.10.2025,2025,cek,169,NH Ostrava,x,92,78,21,16,25,24,27,18,19,20,37,49,45,39,-1
05.10.2025,2025,cek,166,Nymburk,x,89,94,28,20,23,21,28,21,10,32,48,44,49,42,1
05.10.2025,2025,cek,160,Decin,x,83,71,29,23,15,19,20,15,19,14,52,34,35,33,-1
06.10.2025,2025,lat-st,153,Latvijas Universitate,x,81,76,21,18,16,20,26,23,18,15,39,36,49,33,1
05.10.2025,2025,lat-st,160,Rigas Zelli,x,78,82,20,22,19,21,24,18,15,21,42,40,42,36,-1
05.10.2025,2025,lat-st,165,Ventspils,x,95,75,21,13,26,17,24,21,24,24,34,43,45,48,1
04.10.2025,2025,lat-st,160,VEF Riga,x,61,68,18,18,19,21,10,14,14,15,36,40,24,29,-1
06.10.2025,2025,fra,159,Monaco,x,88,71,21,16,25,20,20,17,22,18,37,45,37,40,-1
06.10.2025,2025,fra,156,La Rochelle,x,84,75,23,21,23,20,17,14,21,20,44,43,31,41,-1
06.10.2025,2025,fra,153,Nancy,x,104,96,24,25,22,18,29,32,29,21,49,40,61,50,1
05.10.2025,2025,fra,149,Gravelines-Dunkerque,x,106,74,26,21,25,15,31,17,24,21,47,40,48,45,1
05.10.2025,2025,fra,158,Chalon/Saone,x,87,81,26,23,20,21,19,20,22,17,49,41,39,39,-1
05.10.2025,2025,fra,156,Dijon,x,87,73,15,22,20,13,25,19,27,19,37,33,44,46,1
05.10.2025,2025,fra,165,JL Bourg,x,61,86,16,23,19,23,18,17,8,23,39,42,35,31,-1
06.10.2025,2025,ger,164,Vechta,x,88,77,24,16,20,18,21,17,23,26,40,38,38,49,1
06.10.2025,2025,ger,174,Oldenburg,x,87,78,21,23,20,20,19,21,27,14,44,40,40,41,-1
06.10.2025,2025,ger,169,Alba Berlin,x,91,87,22,23,24,21,24,22,21,21,45,45,46,42,1
06.10.2025,2025,ger,161,Syntainics MBC,x,69,79,15,14,13,25,25,21,16,19,29,38,46,35,1
06.10.2025,2025,ger,166,Bayern,x,81,95,21,24,24,19,17,31,19,21,45,43,48,40,1
05.10.2025,2025,ger,172,Heidelberg,x,65,72,15,19,16,19,17,13,17,21,34,35,30,38,-1
05.10.2025,2025,ger,164,Ludwigsburg,x,63,62,12,19,22,18,15,7,14,18,31,40,22,32,-1
05.10.2025,2025,ger,159,Wurzburg,x,65,92,15,23,12,24,6,26,32,19,38,36,32,51,1
03.10.2025,2025,ger,166,Heidelberg,x,93,108,15,30,26,29,25,25,27,24,45,55,50,51,1
06.10.2025,2025,ger b,161,Bochum,x,70,63,18,12,17,18,14,15,21,18,30,35,29,39,-1
06.10.2025,2025,ger b,155,Koblenz,x,80,62,24,15,14,14,19,12,23,21,39,28,31,44,-1
06.10.2025,2025,ger b,168,Artland,x,96,109,25,34,31,26,18,25,22,24,59,57,43,46,1
06.10.2025,2025,ger b,157,Tubingen,x,77,79,23,21,22,15,15,25,17,18,44,37,40,35,-1
05.10.2025,2025,ger b,160,Giessen,x,91,90,30,22,16,24,27,27,18,17,52,40,54,35,1
05.10.2025,2025,ger b,166,Vechta 2,x,95,71,29,18,25,15,21,18,20,20,47,40,39,40,-1
05.10.2025,2025,ger b,175,Phoenix Hagen,x,78,103,11,30,26,30,24,18,17,25,41,56,42,42,-1
05.10.2025,2025,ger b,158,Jena,x,69,96,19,22,16,27,18,25,16,22,41,43,43,38,1
05.10.2025,2025,ger b,171,Crailsheim Merlins,x,85,94,18,23,22,18,19,30,26,23,41,40,49,49,1
06.10.2025,2025,greek,154,Kolossos Rhodes,x,67,65,13,20,12,17,22,14,20,14,33,29,36,34,-1
06.10.2025,2025,greek,157,Panathinaikos,x,66,80,14,21,17,21,19,17,16,21,35,38,36,37,-1
05.10.2025,2025,greek,155,PAOK,x,72,80,20,18,17,28,18,23,17,11,38,45,41,28,-1
05.10.2025,2025,greek,166,Promitheas,x,80,84,22,14,24,26,13,23,21,21,36,50,36,42,-1
05.10.2025,2025,greek,153,AEK Athens,x,59,70,17,14,12,12,12,18,18,26,31,24,30,44,-1
06.10.2025,2025,isr,162,Hapoel Jerusalem,x,74,81,19,13,14,27,20,18,21,23,32,41,38,44,1
06.10.2025,2025,isr,163,Bnei Herzliya,x,87,93,27,23,13,29,25,20,22,21,50,42,45,43,1
06.10.2025,2025,isr,162,H. Afula,x,67,84,20,22,16,21,12,30,19,11,42,37,42,30,-1
06.10.2025,2025,ita,166,Pistoia,x,84,68,32,19,19,20,17,10,16,19,51,39,27,35,-1
06.10.2025,2025,ita,157,Reggiana,x,74,77,19,13,17,20,22,17,9,17,32,37,39,26,-1
06.10.2025,2025,ita,156,Sassari,x,100,75,23,14,34,17,19,23,24,21,37,51,42,45,1
06.10.2025,2025,ita,168,Trieste,x,83,92,24,20,22,22,21,29,16,21,44,44,50,37,1
06.10.2025,2025,ita,171,Brescia,x,93,95,24,21,20,14,23,33,26,27,45,34,56,53,1
06.10.2025,2025,ita,173,Tortona,x,95,105,28,29,32,22,13,31,22,23,57,54,44,45,1
05.10.2025,2025,ita,167,Trapani,x,71,87,19,21,22,18,12,23,18,25,40,40,35,43,-1
05.10.2025,2025,ita,164,Venezia,x,82,70,17,21,22,20,25,15,18,14,38,42,40,32,-1
06.10.2025,2025,ita b,150,Verona,x,92,86,21,17,19,23,16,21,16,11,38,42,37,27,-1
06.10.2025,2025,ita b,153,Udine,x,58,84,18,19,15,22,19,22,6,21,37,37,41,27,-1
06.10.2025,2025,ita b,154,Orzinuovi,x,84,86,22,18,16,21,27,22,19,25,40,37,49,44,1
06.10.2025,2025,ita b,152,Avellino Basket,x,82,77,21,22,17,12,22,22,22,21,43,29,44,43,1
06.10.2025,2025,ita b,153,Fortitudo Bologna,x,74,66,16,17,12,20,22,12,24,17,33,32,34,41,-1
06.10.2025,2025,ita b,150,Libertas Livorno,x,66,76,22,23,19,13,16,23,9,17,45,32,39,26,-1
06.10.2025,2025,ita b,159,JuVi Cremona,x,72,97,15,14,15,26,27,26,15,31,29,41,53,46,1
06.10.2025,2025,ita b,150,Cantu,x,68,74,20,18,9,18,27,18,12,20,38,27,45,32,1
05.10.2025,2025,ita b,161,Assigeco Piacenza,x,86,73,20,27,28,17,18,16,20,13,47,45,34,33,-1
06.10.2025,2025,lat lkl,164,Neptunas,x,92,99,17,32,29,24,27,21,19,22,49,53,48,41,1
06.10.2025,2025,lat lkl,164,Zalgiris Kaunas,x,91,88,22,18,28,17,23,25,18,28,40,45,48,46,1
05.10.2025,2025,lat lkl,174,Siauliai,x,104,93,23,25,29,27,28,13,24,28,48,56,41,52,1
05.10.2025,2025,lat lkl,164,BC Wolves,x,86,95,26,25,26,25,13,24,21,21,51,51,37,42,-1
05.10.2025,2025,lat lkl,165,Lietkabelis,x,78,85,30,19,15,21,17,18,16,27,49,36,35,43,-1
06.10.2025,2025,mak,,Kozuv,x,99,79,20,28,20,13,30,18,29,20,48,33,48,49,
06.10.2025,2025,mak,,Pelister,x,84,96,21,23,16,26,20,27,27,20,44,42,47,47,
06.10.2025,2025,mak,,Gostivar,x,70,76,14,21,25,21,18,17,13,17,35,46,35,30,
05.10.2025,2025,mak,,Feniks 2010,x,90,85,33,19,8,35,25,14,24,17,52,43,39,41,
05.10.2025,2025,mak,,MZT Skopje,x,59,95,18,20,9,22,18,22,14,31,38,31,40,45,
05.10.2025,2025,mak,,MKK Kumanovo,x,81,70,20,20,15,17,23,20,23,13,40,32,43,36,
06.10.2025,2025,pol,157,Spojnia Stargard,x,71,79,22,18,12,21,23,21,14,19,40,33,44,33,-1
06.10.2025,2025,pol,165,Dabrowa Gornicza,x,68,77,21,19,16,27,20,16,11,15,40,43,36,26,-1
06.10.2025,2025,pol,162,Slask Wroclaw,x,91,73,21,19,25,13,20,24,25,17,40,38,44,42,1
05.10.2025,2025,pol,172,Lublin,x,90,96,21,22,23,26,21,24,25,24,43,49,45,49,1
05.10.2025,2025,pol,170,Trefl Sopot,x,89,97,14,34,24,27,23,21,28,15,48,51,44,43,1
05.10.2025,2025,pol,159,Ostrow Wielkopolski,x,88,63,23,14,17,17,13,21,35,11,37,34,34,46,1
04.10.2025,2025,pol,163,Anwil Wloclawek,x,70,97,21,25,18,25,21,23,10,24,46,43,44,34,-1
04.10.2025,2025,pol,161,Szczecin,x,72,82,18,20,24,24,21,24,9,14,38,48,45,23,-1
06.10.2025,2025,vtb,152,Enisey,x,83,65,12,21,33,6,20,13,18,25,33,39,33,43,-1
06.10.2025,2025,vtb,175,Lokomotiv Kuban,x,76,83,15,17,19,15,20,23,22,28,32,34,43,50,1
06.10.2025,2025,vtb,149,MBA Moscow,x,83,54,19,5,22,15,23,17,19,17,24,37,40,36,1
06.10.2025,2025,vtb,157,Unics Kazan,x,65,87,16,27,21,15,6,27,22,18,43,36,33,40,-1
06.10.2025,2025,vtb,156,Saratov,x,52,74,14,20,14,17,14,23,10,14,34,31,37,24,-1
05.10.2025,2025,vtb,156,CSKA Moscow,x,77,75,18,19,10,18,24,20,25,18,37,28,44,43,1
06.10.2025,2025,sırbistan,168,Mladost Zemun,x,72,78,17,24,18,12,18,16,19,26,41,30,34,45,-1
06.10.2025,2025,sırbistan,162,Radnicki,x,78,84,20,17,15,23,18,22,25,22,37,38,40,47,1
06.10.2025,2025,sırbistan,166,Sloboda,x,75,57,24,19,20,13,22,12,9,13,43,33,34,22,-1
06.10.2025,2025,sırbistan,166,Sloga,x,95,86,29,13,26,25,22,28,18,20,42,51,50,38,1
05.10.2025,2025,sırbistan,163,Vrsac,x,76,77,25,17,13,18,19,24,19,18,42,31,43,37,-1
05.10.2025,2025,sırbistan,165,KK Metalac,x,85,84,27,19,20,24,20,26,18,15,46,44,46,33,-1
05.10.2025,2025,sırbistan,160,BBK Radnicki,x,75,82,18,29,13,18,17,17,27,18,47,31,34,45,-1
04.10.2025,2025,sır,157,Vojvodina Novi Sad,x,64,80,14,22,16,20,12,23,22,15,36,36,35,37,-1
06.10.2025,2025,tur,170,Buyukcekmece,x,97,85,16,18,33,26,16,18,32,23,34,59,34,55,1
06.10.2025,2025,tur,165,Yalovaspor,x,100,59,29,13,31,12,21,15,19,19,42,43,36,38,-1
06.10.2025,2025,tur,169,Darussafaka,x,108,85,22,28,31,12,34,19,21,26,50,43,53,47,1
06.10.2025,2025,tur,163,Karsiyaka,x,82,68,23,18,29,24,12,10,18,16,41,53,22,34,-1
05.10.2025,2025,tur,165,Besiktas,x,99,95,30,30,24,20,19,23,26,22,60,44,42,48,1
05.10.2025,2025,tur,162,Galatasaray,x,72,70,11,22,18,22,20,13,23,13,33,40,33,36,-1
05.10.2025,2025,tur,173,Bursaspor,x,73,81,19,22,12,19,22,15,20,25,41,31,37,45,-1
04.10.2025,2025,tur,166,Mersin BŞB,x,65,75,20,21,13,21,13,16,19,17,41,34,29,36,-1
06.10.2025,2025,tur b,160,Harem Spor,x,86,75,24,24,22,16,19,24,21,11,48,38,43,32,-1
06.10.2025,2025,tur b,162,Gaziantep,x,75,82,25,15,19,18,10,22,21,27,40,37,32,48,-1
06.10.2025,2025,tur b,163,Trabzonspor,x,84,80,24,15,21,6,24,32,15,27,39,27,56,42,1
05.10.2025,2025,tur b,156,OGM Ormanspor,x,86,79,22,20,27,14,17,16,20,29,42,41,33,49,1
05.10.2025,2025,tur b,154,Çağdaş Bodrum Spor,x,81,64,27,15,24,13,14,14,16,22,42,37,28,38,-1
05.10.2025,2025,tur b,148,Balikesir,x,84,73,25,17,19,19,17,13,23,24,42,38,30,47,1
05.10.2025,2025,tur b,153,CO Basket,x,73,81,22,21,23,21,13,25,15,14,43,44,38,29,-1
04.10.2025,2025,tur b,159,Fenerbahce 2,x,67,57,21,11,14,15,17,18,15,13,32,29,35,28,-1
06.10.2025,2025,ukr,,Kryvbas,x,46,69,11,18,12,24,7,12,16,15,29,36,19,31,
06.10.2025,2025,ukr,,Cherkaski Mavpy,x,82,63,27,19,10,12,23,11,22,21,46,22,34,43,
05.10.2025,2025,ukr,,Cherkaski Mavpy,x,80,90,27,28,18,28,16,15,19,19,55,46,31,38,
05.10.2025,2025,ukr,,Kryvbas,x,83,48,21,18,29,5,19,7,14,18,39,34,26,32,
04.10.2025,2025,ukr,,Rivne,x,67,75,16,19,14,20,19,21,18,15,35,34,40,33,
04.10.2025,2025,ukr,,Stariy Lutsk,x,63,67,11,14,17,19,15,17,20,17,25,36,32,37,
04.10.2025,2025,ukr,,Stariy Lutsk,x,89,86,10,26,27,19,14,15,26,17,36,46,29,43,
03.10.2025,2025,ukr,,Rivne,x,65,84,13,22,18,21,14,21,20,20,35,39,35,40,
06.10.2025,2025,mak,,Kozuv,x,99,79,20,28,20,13,30,18,29,20,48,33,48,49,
06.10.2025,2025,mak,,Gostivar,x,70,76,14,21,25,21,18,17,13,17,35,46,35,30,
05.10.2025,2025,mak,,Feniks 2010,x,90,85,33,19,8,35,25,14,24,17,52,43,39,41,
05.10.2025,2025,mak,,MZT Skopje,x,59,95,18,20,9,22,18,22,14,31,38,31,40,45,
05.10.2025,2025,mak,,MKK Kumanovo,x,81,70,20,20,15,17,23,20,23,13,40,32,43,36,
08.10.2025,2025,kore,171,Seoul Knights,x,75,84,15,27,24,16,24,21,12,20,42,40,45,32,-1
08.10.2025,2025,kore,163,Suwon KT,x,65,76,13,18,17,19,22,19,13,20,31,36,41,33,-1
07.10.2025,2025,kore,168,Sangmu,x,76,64,19,16,15,15,19,21,23,12,35,30,40,35,-1
07.10.2025,2025,kore,171,Goyang Sono,x,77,83,18,22,14,23,27,18,18,20,40,37,45,38,-1
06.10.2025,2025,kore,167,Wonju DB,x,81,107,20,28,15,29,30,28,16,22,48,44,58,38,1
06.10.2025,2025,kore,173,KCC Egis,x,84,74,25,14,27,16,18,29,14,15,39,43,47,29,-1
05.10.2025,2025,kore,172,Mobis Phoebus,x,74,90,21,18,17,20,15,33,21,19,39,37,48,40,1
05.10.2025,2025,kore,173,Seoul Thunders,x,80,87,19,27,11,19,28,17,22,24,46,30,45,46,1
07.10.2025,2025,rom,151,SCM Craiova,x,80,67,22,20,24,13,11,12,23,22,42,37,23,45,-1
07.10.2025,2025,rom,166,Municipal Galati,x,103,88,24,24,23,21,19,16,37,27,48,44,35,64,1
05.10.2025,2025,rom,163,Valcea,x,55,92,13,21,19,30,8,23,15,18,34,49,31,33,-1
05.10.2025,2025,rom,150,BC Steaua Bucuresti,x,77,83,16,18,17,20,23,25,21,20,34,37,48,41,1
05.10.2025,2025,rom,156,Petrolul Ploiesti,x,82,66,20,15,20,11,20,23,22,17,35,31,43,39,1
05.10.2025,2025,rom,154,BC Timisoara,x,78,76,22,10,20,25,17,22,19,19,32,45,39,38,-1
27.09.2025,2025,fiba euro,161,Dinamo Zagreb,x,105,57,28,20,22,16,30,12,25,9,48,38,42,34,-1
27.09.2025,2025,fiba euro,154,Spirou Charleroi,x,79,72,23,18,14,15,27,21,15,18,41,29,48,33,1
27.09.2025,2025,fiba euro,159,Neptunas,x,95,59,18,24,29,12,26,15,22,8,42,41,41,30,-1
27.09.2025,2025,fiba euro,156,Starlites,x,87,75,26,9,25,27,20,22,16,17,35,52,42,33,-1
27.09.2025,2025,fiba euro,172,BC Prievidza,x,104,84,31,31,28,14,27,16,18,23,62,42,43,41,-1
26.09.2025,2025,fiba euro,155,CSM Constanta,x,71,84,18,30,18,17,13,23,22,14,48,35,36,36,-1
26.09.2025,2025,fiba euro,169,Maroussi,x,81,106,28,22,25,28,13,32,15,24,50,53,45,39,-1
24.09.2025,2025,fiba euro,155,Sporting CP,x,69,69,18,22,15,18,18,18,18,11,40,33,36,29,-1
24.09.2025,2025,fiba euro,156,Anorthosis,x,74,81,18,22,24,27,19,21,13,11,40,51,40,24,-1
24.09.2025,2025,fiba euro,162,BC Dnipro,x,69,71,15,17,16,13,15,18,23,23,32,29,33,46,-1
24.09.2025,2025,fiba euro,156,Dijon,x,84,95,24,24,18,23,21,26,21,22,48,41,47,43,1
24.09.2025,2025,fiba euro,169,Peja,x,98,75,34,20,20,23,20,15,24,17,54,43,35,41,-1
24.09.2025,2025,fiba euro,165,Alba Fehervar,x,102,85,23,18,26,24,25,21,28,22,41,50,46,50,1
24.09.2025,2025,fiba euro,160,Bilbao,x,66,74,19,21,12,16,15,16,20,21,40,28,31,41,-1
04.10.2025,2025,fin,171,KTP Kotka Basket,x,94,87,23,16,13,28,20,15,23,20,39,41,35,43,-1
04.10.2025,2025,fin,162,Karhu Basket,x,71,79,20,22,20,23,18,16,13,18,42,43,34,31,-1
04.10.2025,2025,fin,165,UU-Korihait Uusikaupunki,x,74,86,17,21,20,26,18,11,19,28,38,46,29,47,-1
04.10.2025,2025,fin,167,Salon Vilpas,x,94,85,22,32,29,22,19,15,24,16,54,51,34,40,-1
04.10.2025,2025,fin,165,Kouvot Kouvola,x,76,89,18,21,18,20,22,32,18,16,39,38,54,34,1
04.10.2025,2025,fin,164,Kataja,x,66,100,12,30,17,30,22,18,15,22,42,47,40,37,-1
05.10.2025,2025,bnxt,157,Zwolle,x,92,69,28,18,17,16,23,22,24,13,46,33,45,37,1
05.10.2025,2025,bnxt,151,Donar Groningen,x,93,91,19,17,19,22,30,24,25,28,36,41,54,53,1
05.10.2025,2025,bnxt,152,Den Helder,x,80,74,29,28,23,14,11,15,17,17,57,37,26,34,-1
05.10.2025,2025,bnxt,148,Limburg,x,66,86,23,24,16,19,14,23,13,20,47,35,37,33,-1
05.10.2025,2025,bnxt,159,Oostende,x,86,92,19,18,18,28,22,18,27,28,37,46,40,55,1
05.10.2025,2025,bnxt,159,Belfius Mons,x,71,84,18,25,17,19,14,21,22,19,43,36,35,41,-1
10.10.2025,2025,rus,149,Chelyabinsk,Irkutsk,73,71,14,25,21,14,13,13,16,12,39,35,26,28,-1
10.10.2025,2025,rus,153,Metallurg,Dynamo Vladivostok,69,76,16,22,16,18,19,16,18,20,38,34,35,38,-1
08.10.2025,2025,rus,149,CSKA Moscow 2,Dome-Springs Izhevsk,77,63,21,19,15,16,23,12,18,16,40,31,35,34,-1
08.10.2025,2025,rus,145,Dynamo Grozny,Barnaul,67,70,27,18,14,14,10,21,16,17,45,28,31,33,-1
08.10.2025,2025,rus,146,Khimki M.,Bars Rostov,71,61,10,11,21,12,17,16,23,22,21,33,33,45,1
08.10.2025,2025,rus,152,Tambov,Temp Sumz Revda,60,78,14,21,19,21,17,24,10,12,35,40,41,22,-1
08.10.2025,2025,rus,148,Zenit Petersburg 2,Novosibirsk,85,69,20,19,22,18,21,21,22,11,39,40,42,33,1
08.10.2025,2025,rus,154,University-Ugra,Lokomotiv Kuban 2,81,75,20,24,18,18,17,17,26,16,44,36,34,42,-1
07.10.2025,2025,rus,145,Chelyabinsk,Dynamo Vladivostok,66,73,20,27,19,13,14,22,13,11,47,32,36,24,-1
07.10.2025,2025,rus,145,Metallurg,Irkutsk,71,90,17,18,13,27,24,20,17,25,35,40,44,42,1
10.10.2025,2025,eurolig,168,Real Madrid,Partizan,93,86,24,24,26,23,18,17,25,22,48,49,35,47,-1
10.10.2025,2025,eurolig,161,Panathinaikos,Bayern,94,79,25,16,22,18,19,24,28,21,41,40,43,49,1
10.10.2025,2025,eurolig,160,Lyon-Villeurbanne,Virtus Bologna,87,85,38,27,19,22,16,21,14,15,65,41,37,29,-1
10.10.2025,2025,eurolig,162,Anadolu Efes,Fenerbahce,78,83,21,27,16,19,14,14,27,23,48,35,28,50,-1
09.10.2025,2025,eurolig,165,Crvena zvezda,Baskonia,78,71,25,20,17,14,17,15,19,22,45,31,32,41,-1
09.10.2025,2025,eurolig,164,Monaco,Maccabi Tel Aviv,85,79,21,23,20,23,24,14,20,19,44,43,38,39,-1
04.10.2025,2025,eurolig,163,Paris,Crvena zvezda,77,80,18,17,25,18,15,23,19,22,35,43,38,41,-1
04.10.2025,2025,eurolig,162,Virtus Bologna,Anadolu Efes,67,76,21,15,15,21,16,15,15,25,36,36,31,40,-1
04.10.2025,2025,eurolig,159,Fenerbahce,Olympiacos,82,71,17,13,15,23,25,20,25,15,30,38,45,40,1
03.10.2025,2025,eurolig,164,Maccabi Tel Aviv,Lyon-Villeurbanne,89,82,24,31,27,21,20,19,18,11,55,48,39,29,-1
03.10.2025,2025,eurolig,161,Bayern,Real Madrid,97,89,26,29,26,22,12,22,33,16,55,48,34,49,1
03.10.2025,2025,eurolig,167,Baskonia,Partizan,88,82,16,17,16,21,27,22,29,22,33,37,49,51,1
03.10.2025,2025,eurolig,153,Monaco,Olimpia Milano,93,80,22,10,25,16,19,23,27,31,32,41,42,58,1
03.10.2025,2025,eurolig,160,Zalgiris Kaunas,Barcelona,74,67,21,14,22,17,7,17,24,19,35,39,24,43,-1
03.10.2025,2025,eurolig,162,Alba Berlin,Panathinaikos,77,87,17,26,19,19,21,17,20,25,43,38,38,45,1
09.10.2025,2025,aba 2,151,Cedevita Junior,MZT Skopje,77,75,22,24,14,22,17,13,15,9,46,36,30,24,-1
09.10.2025,2025,aba 2,150,Helios Domzale,Tivat,69,62,16,14,12,20,21,12,20,16,30,32,33,36,-1
09.10.2025,2025,aba 2,151,KK Bosna,Sutjeska,78,74,26,18,19,15,16,19,17,22,44,34,35,39,-1
08.10.2025,2025,aba 2,156,Vojvodina Novi Sad,Rabotnicki,93,62,28,20,19,18,26,12,20,12,48,37,38,32,-1
10.10.2025,2025,lat nkl,154,BC Olimpas Palanga,Neptunas 2,63,68,18,20,14,18,17,19,14,11,38,32,36,25,-1
10.10.2025,2025,lat nkl,155,Kretinga,Zalgiris Kaunas 2,65,90,10,24,11,21,21,21,23,24,34,32,42,47,1
10.10.2025,2025,lat nkl,166,Ukmerges Stekas,Vytis VDU,88,95,16,15,26,23,17,31,29,26,31,49,48,55,1
10.10.2025,2025,lat nkl,162,Omega-Tauras,Rytas 2,93,68,25,23,20,12,25,19,23,14,48,32,44,37,-1
10.10.2025,2025,lat nkl,160,Silute,Vilkaviskis,82,92,16,24,30,22,18,28,18,18,40,52,46,36,1
10.10.2025,2025,lat nkl,164,Suduva-Mantinga,Delikatesas Joniskis,93,65,24,13,27,16,26,17,16,19,37,43,43,35,-1
10.10.2025,2025,lat nkl,157,Telsiai,Plunges Olimpas,81,76,16,25,22,13,19,21,24,17,41,35,40,41,1
10.10.2025,2025,lat nkl,161,Alytaus Alytus,Jurbarkas,74,97,14,35,19,18,18,24,23,20,49,37,42,43,1
05.10.2025,2025,lat nkl,158,Jurbarkas,Kretinga,87,86,22,17,14,19,28,26,23,24,39,33,54,47,1
05.10.2025,2025,lat nkl,163,Delikatesas Joniskis,Rytas 2,70,80,21,32,20,20,16,16,13,12,53,40,32,25,-1
05.10.2025,2025,lat nkl,156,Neptunas 2,Suduva-Mantinga,87,81,17,19,16,20,21,21,33,21,36,36,42,54,1
05.10.2025,2025,lat nkl,150,Plunges Olimpas,Ukmerges Stekas,73,93,26,22,16,28,11,21,20,22,48,44,32,42,-1
05.10.2025,2025,lat nkl,162,Silute,Omega-Tauras,75,85,27,22,15,16,13,21,20,26,49,31,34,46,-1
05.10.2025,2025,lat nkl,164,Vytis VDU,BC Olimpas Palanga,90,85,20,26,25,21,23,13,22,25,46,46,36,47,1
05.10.2025,2025,lat nkl,148,Zalgiris Kaunas 2,Telsiai,63,76,16,14,16,15,13,24,18,23,30,31,37,41,1
05.10.2025,2025,lat nkl,164,Vilkaviskis,Alytaus Alytus,75,73,16,21,23,17,16,18,20,17,37,40,34,37,-1
10.10.2025,2025,tur b,167,MKE Ankaragucu,Konya BBSK,97,83,20,7,19,29,32,26,26,21,27,48,58,47,1
10.10.2025,2025,tur b,157,Kapakli Spor,Bordo Sportif,81,77,18,24,21,17,16,19,20,15,42,38,35,35,-1
10.10.2025,2025,tur b,,Trabzonspor,Final Spor,70,66,18,13,8,16,19,22,25,15,31,24,41,40,
09.10.2025,2025,tur b,153,Balikesir,Istanbul Anka Spor,100,60,22,17,29,11,23,19,26,13,39,40,42,39,1
09.10.2025,2025,tur b,151,Çağdaş Bodrum Spor,iLab Basketbol,80,75,10,18,18,19,25,19,27,19,28,37,44,46,1
09.10.2025,2025,tur b,155,Harem Spor,OGM Ormanspor,84,61,33,11,12,18,22,16,17,16,44,30,38,33,-1
09.10.2025,2025,tur b,162,Gaziantep,Cayirova,77,80,27,24,9,10,20,23,21,23,51,19,43,44,1
09.10.2025,2025,tur b,155,Fenerbahce 2,Ankara Kolejliler,52,61,8,15,17,10,12,15,15,21,23,27,27,36,-1
09.10.2025,2025,tur b,152,CO Basket,Esenler Erokspor,70,88,19,20,10,22,21,24,20,22,39,32,45,42,1
07.10.2025,2025,tur b,161,Final Spor,Kapakli Spor,83,61,20,12,23,20,23,15,17,14,32,43,38,31,-1
10.10.2025,2025,pol,170,Zielona Gora,Torun,68,79,16,26,14,22,21,15,17,16,42,36,36,33,-1
09.10.2025,2025,pol,166,Gdynia,Slask Wroclaw,81,100,19,25,22,20,24,26,16,29,44,42,50,45,1
09.10.2025,2025,cek,154,Brno,Pardubice,89,82,22,21,17,24,25,15,25,22,43,41,40,47,1
09.10.2025,2025,cek,170,Decin,Olomoucko,63,77,16,22,12,20,22,16,13,19,38,32,38,32,-1
09.10.2025,2025,cek,171,NH Ostrava,Usti n. Labem,72,87,10,21,16,18,18,18,28,30,31,34,36,58,1
09.10.2025,2025,cek,168,Srsni Pisek,Slavia Prague,81,66,19,11,33,21,11,13,18,21,30,54,24,39,-1
09.10.2025,2025,cek,162,USK Prague,Opava,86,78,22,29,18,15,23,12,23,22,51,33,35,45,-1
09.10.2025,2025,eurocup,158,Gran Canaria,Bahcesehir Kol.,66,63,16,10,16,17,16,22,18,14,26,33,38,32,-1
09.10.2025,2025,eurocup,165,Trento,Buducnost,64,85,16,18,19,24,9,23,20,20,34,43,32,40,-1
09.10.2025,2025,eurocup,171,Hapoel Jerusalem,Hamburg,89,74,21,18,25,19,13,17,30,20,39,44,30,50,-1
09.10.2025,2025,eurocup,163,Trefl Sopot,Joventut Badalona,73,78,18,19,19,21,21,15,15,23,37,40,36,38,-1
09.10.2025,2025,eurocup,167,Cluj-Napoca,Valencia,96,105,24,19,28,25,23,26,21,35,43,53,49,56,1
08.10.2025,2025,eurocup,166,Besiktas,Hapoel Tel-Aviv,87,101,22,24,19,30,21,27,25,20,46,49,48,45,1
08.10.2025,2025,eurocup,159,Venezia,JL Bourg,66,88,17,17,19,27,17,32,13,12,34,46,49,25,-1
08.10.2025,2025,eurocup,159,Turk Telekom,Cedevita Olimpija,78,70,26,22,17,15,14,15,21,18,48,32,29,39,-1
08.10.2025,2025,eurocup,170,BC Wolves,Ulm,76,94,20,21,21,24,25,23,10,26,41,45,48,36,-1
08.10.2025,2025,eurocup,151,Lietkabelis,Aris,74,92,16,19,16,23,23,28,19,22,35,39,51,41,1
09.10.2025,2025,fiba,162,Unicaja,Szczecin,83,60,17,21,21,14,22,15,23,10,38,35,37,33,-1
09.10.2025,2025,fiba,160,FMP Beograd,Manisa,97,101,20,17,24,31,26,21,27,32,37,55,47,59,1
09.10.2025,2025,fiba,162,Vechta,Promitheas,86,88,16,29,25,21,30,24,15,14,45,46,54,29,1
09.10.2025,2025,fiba,162,Petkim Spor,Oostende,77,74,21,25,21,16,15,13,20,20,46,37,28,40,-1
08.10.2025,2025,fiba,162,Hapoel Holon,Nanterre,70,76,20,24,14,11,15,21,21,20,44,25,36,41,-1
08.10.2025,2025,fiba,168,Galatasaray,Nymburk,75,87,13,23,24,23,20,20,18,21,36,47,40,39,-1
08.10.2025,2025,fiba,157,Peristeri,Murcia,76,81,22,24,13,18,20,16,21,23,46,31,36,44,1
08.10.2025,2025,fiba,156,Wurzburg,Igokea,98,80,21,23,20,18,33,17,24,22,44,38,50,46,1
09.10.2025,2025,fiba euro,154,FC Porto,Szolnoki Olaj,77,68,20,16,18,10,19,23,20,19,36,28,42,39,1
09.10.2025,2025,fiba euro,152,Limburg,PAOK,70,74,21,21,21,14,16,14,12,25,42,35,30,37,-1
09.10.2025,2025,fiba euro,152,Spirou Charleroi,Sabah Baku,82,81,24,26,25,16,18,20,15,19,50,41,38,34,-1
09.10.2025,2025,fiba euro,161,Basket Zaragoza,Bursaspor,106,84,26,25,26,13,28,19,26,27,51,39,47,53,1
09.10.2025,2025,fiba euro,159,Basketball Braunschweig,AEK Larnaca,89,59,12,21,20,11,29,15,28,12,33,31,44,40,1
09.10.2025,2025,fiba euro,161,Bilbao,Balkan,95,55,27,16,17,13,18,17,33,9,43,30,35,42,-1
09.10.2025,2025,fiba euro,157,Dijon,Trepca,118,73,34,27,28,12,28,15,28,19,61,40,43,47,1
09.10.2025,2025,fiba euro,155,CSM Constanta,Antwerp Giants,70,88,16,31,15,17,18,25,21,15,47,32,43,36,1
09.10.2025,2025,fiba euro,165,Maroussi,Norrkoping,99,80,14,19,30,24,24,19,31,18,33,54,43,49,1
09.10.2025,2025,fiba euro,173,BC Prievidza,Kutaisi,77,69,17,18,20,22,24,12,16,17,35,42,36,33,-1
09.10.2025,2025,fiba euro,166,Tofas,Keravnos,99,81,30,15,19,14,16,33,34,19,45,33,49,53,1
09.10.2025,2025,fiba euro,155,BC Kalev/Cramo,Le Portel,66,63,14,13,24,16,14,17,14,17,27,40,31,31,-1
09.10.2025,2025,fiba euro,175,Alba Fehervar,Rilski Sportist,100,88,30,17,22,20,33,21,15,30,47,42,54,45,1
09.10.2025,2025,fiba euro,158,Anwil Wloclawek,BC Dnipro,114,71,32,20,28,18,23,19,31,14,52,46,42,45,1
09.10.2025,2025,fiba euro,151,Arges Pitesti,Parnu,67,65,25,17,15,17,15,19,12,12,42,32,34,24,-1
09.10.2025,2025,fiba euro,158,CSM Oradea,Spojnia Stargard,77,75,20,16,16,28,22,10,19,21,36,44,32,40,-1
08.10.2025,2025,fiba euro,161,Cholet,Fribourg Olympic,90,75,27,17,20,22,21,15,22,21,44,42,36,43,-1
08.10.2025,2025,fiba euro,159,Sporting CP,Sassari,69,82,14,32,25,16,13,27,17,7,46,41,40,24,-1
08.10.2025,2025,fiba euro,161,Ludwigsburg,Caledonia Gladiators,86,62,21,14,15,12,23,17,27,19,35,27,40,46,1
08.10.2025,2025,fiba euro,158,Anorthosis,Levice,72,83,19,22,19,16,18,18,16,27,41,35,36,43,-1
09.10.2025,2025,aba,157,Cibona,KK Krka Novo mesto,74,81,24,20,17,20,23,19,10,22,44,37,42,32,-1
07.10.2025,2025,aba,152,Studentski Centar,Zadar,86,62,19,15,21,15,24,18,22,14,34,36,42,36,1
09.10.2025,2025,lat-st,170,Tal Tech,Keila Coolbet,86,82,17,22,15,20,26,23,28,17,39,35,49,45,1
09.10.2025,2025,lat-st,158,VEF Riga,Viimsi,89,52,21,10,18,11,28,10,22,21,31,29,38,43,1
08.10.2025,2025,lat-st,168,Ventspils,Keila KK,116,78,31,15,23,15,33,22,29,26,46,38,55,55,1
09.10.2025,2025,fin,160,Karhu Basket,Helsinki Seagulls,80,78,20,12,18,24,21,20,21,22,32,42,41,43,1
09.10.2025,2025,fin,162,Kataja,BC Nokia,92,74,18,22,31,15,19,19,24,18,40,46,38,42,-1
09.10.2025,2025,fin,167,Salon Vilpas,Kobrat,89,81,25,22,14,20,26,21,24,18,47,34,47,42,1
09.10.2025,2025,fin,164,UU-Korihait Uusikaupunki,Pyrinto Tampere,83,76,20,23,19,17,16,20,28,16,43,36,36,44,-1
08.10.2025,2025,fin,173,Kouvot Kouvola,Honka,77,91,20,21,18,27,18,20,21,23,41,45,38,44,-1
08.10.2025,2025,fin,165,KTP Kotka Basket,Bisons Loimaa,71,74,17,21,24,13,18,19,12,21,38,37,37,33,-1
08.10.2025,2025,fin,171,Honka,KTP Kotka Basket,94,87,23,16,13,28,20,15,23,20,39,41,35,43,-1
09.10.2025,2025,mac,162,KTE-Duna,Szedeak,70,74,22,18,17,18,16,18,15,20,40,35,34,35,-1
09.10.2025,2025,mac,165,Pecsi VSK,Atomeromu Paks,81,103,12,25,18,27,25,29,26,22,37,45,54,48,1
09.10.2025,2025,mac,172,Szombathely,Kormend,91,81,28,19,25,21,16,19,22,22,47,46,35,44,-1
09.10.2025,2025,mac,164,Zalakeramia,Soproni KC,108,85,29,17,23,18,24,17,32,33,46,41,41,65,1
08.10.2025,2025,mac,,Budapesti Honved Se,NKA Pecs,79,84,22,14,14,23,22,23,21,24,36,37,45,45,
05.10.2025,2025,mac,158,KTE-Duna,Szombathely,67,98,17,29,19,22,11,20,20,27,46,41,31,47,-1
05.10.2025,2025,mac,170,Kormend,Pecsi VSK,91,84,19,26,25,20,26,22,21,16,45,45,48,37,-1
05.10.2025,2025,mac,165,OSE Lions,Zalakeramia,83,78,13,24,23,23,24,16,23,15,37,46,40,38,-1
05.10.2025,2025,mac,160,NKA Pecs,Soproni KC,81,70,20,14,18,16,23,19,20,21,34,34,42,41,1
09.10.2025,2025,ita b,152,Cantu,Brindisi,75,57,20,8,25,17,15,17,15,15,28,42,32,30,-1
09.10.2025,2025,ita b,155,Fortitudo Bologna,Orzinuovi,80,75,25,23,19,22,20,23,16,7,48,41,43,23,-1
10.10.2025,2025,lat cup,176,Jonava,Siauliai,87,84,21,22,22,18,21,24,23,20,43,40,45,43,-1
09.10.2025,2025,lat cup,167,Neptunas,Mazeikiai,106,71,25,19,27,15,32,24,22,13,44,42,56,35,1
09.10.2025,2025,lat cup,170,Juventus,Nevezis,87,74,24,19,22,20,17,18,24,17,43,42,35,41,-1
02.10.2025,2025,lat cup,166,Siauliai,Neptunas,102,82,18,17,20,26,29,23,35,16,35,46,52,51,1
02.10.2025,2025,lat cup,173,Jonava,Nevezis,93,80,16,18,19,22,32,15,26,25,34,41,47,51,1
02.10.2025,2025,lat cup,158,Mazeikiai,Juventus,73,86,15,28,27,19,17,20,14,19,43,46,37,33,-1
09.10.2025,2025,vtb,158,Zenit Petersburg,Nizhny Novgorod,81,78,21,22,21,19,27,14,12,23,43,40,41,35,-1
09.10.2025,2025,vtb,153,Uralmash Ekaterinburg,Parma Perm,56,63,12,19,11,19,6,9,27,16,31,30,15,43,-1
09.10.2025,2025,slovak,173,SPU Nitra,Inter Bratislava,75,91,18,24,15,11,18,33,24,23,42,26,51,47,1
05.10.2025,2025,slovak,164,BKM Lucenec,BC Komarno,78,102,16,32,23,20,14,28,25,22,48,43,42,47,1
05.10.2025,2025,slovak,165,Iskra Svit,BC Prievidza,85,104,24,26,14,31,22,27,25,20,50,45,49,45,1
05.10.2025,2025,slovak,162,MBK Handlova,Nitra Blue Wings,76,66,18,16,21,16,9,13,28,21,34,37,22,49,-1
05.10.2025,2025,slovak,172,Spisski Rytieri,SPU Nitra,122,101,32,13,36,20,29,39,25,29,45,56,68,54,1
05.10.2025,2025,slovak,164,Levice,Inter Bratislava,99,82,24,27,31,22,25,17,19,16,51,53,42,35,-1
10.10.2025,2025,kore,166,KCC Egis,LG Sakers,92,88,15,33,39,12,24,19,14,24,48,51,43,38,-1
09.10.2025,2025,kore,167,Mobis Phoebus,Anyang JungKwanJang,92,70,30,21,16,12,27,14,19,23,51,28,41,42,-1
09.10.2025,2025,kore,161,Seoul Thunders,KoGas,73,88,23,22,23,24,16,18,11,24,45,47,34,35,-1
10.10.2025,2025,tur b,166,MKE Ankaragucu,Konya BBSK,97,83,20,7,19,29,32,26,26,21,27,48,58,47,1
10.10.2025,2025,tur b,156,Kapakli Spor,Bordo Sportif,81,77,18,24,21,17,16,19,20,15,42,38,35,35,-1
10.10.2025,2025,tur b,153,Trabzonspor,Final Spor,70,66,18,13,8,16,19,22,25,15,31,24,41,40,1
09.10.2025,2025,tur b,153,Balikesir,Istanbul Anka Spor,100,60,22,17,29,11,23,19,26,13,39,40,42,39,1
09.10.2025,2025,tur b,151,Çağdaş Bodrum Spor,iLab Basketbol,80,75,10,18,18,19,25,19,27,19,28,37,44,46,1
09.10.2025,2025,tur b,155,Harem Spor,OGM Ormanspor,84,61,33,11,12,18,22,16,17,16,44,30,38,33,-1
09.10.2025,2025,tur b,163,Gaziantep,Cayirova,77,80,27,24,9,10,20,23,21,23,51,19,43,44,1
09.10.2025,2025,tur b,156,Fenerbahce 2,Ankara Kolejliler,52,61,8,15,17,10,12,15,15,21,23,27,27,36,-1
09.10.2025,2025,tur b,152,CO Basket,Esenler Erokspor,70,88,19,20,10,22,21,24,20,22,39,32,45,42,1
07.10.2025,2025,tur b,161,Final Spor,Kapakli Spor,83,61,20,12,23,20,23,15,17,14,32,43,38,31,-1
05.10.2025,2025,sloven,158,Sencur,Ilirija,91,100,24,17,22,24,15,28,25,17,41,46,43,42,1
05.10.2025,2025,sloven,155,Rogaska,Zlatorog Lasko,94,66,23,27,23,13,18,13,30,13,50,36,31,43,-1
05.10.2025,2025,sloven,157,Tajfun Sentjur,LTH Castings,75,73,17,17,20,14,17,16,21,26,34,34,33,47,1
10.10.2025,2025,rus,149,Irkutsk,x,73,71,14,25,21,14,13,13,16,12,39,35,26,28,-1
10.10.2025,2025,rus,153,Dynamo Vladivostok,x,69,76,16,22,16,18,19,16,18,20,38,34,35,38,-1
08.10.2025,2025,rus,149,Dome-Springs Izhevsk,x,77,63,21,19,15,16,23,12,18,16,40,31,35,34,-1
08.10.2025,2025,rus,145,Barnaul,x,67,70,27,18,14,14,10,21,16,17,45,28,31,33,-1
08.10.2025,2025,rus,146,Bars Rostov,x,71,61,10,11,21,12,17,16,23,22,21,33,33,45,1
08.10.2025,2025,rus,152,Temp Sumz Revda,x,60,78,14,21,19,21,17,24,10,12,35,40,41,22,-1
08.10.2025,2025,rus,148,Novosibirsk,x,85,69,20,19,22,18,21,21,22,11,39,40,42,33,1
08.10.2025,2025,rus,154,Lokomotiv Kuban 2,x,81,75,20,24,18,18,17,17,26,16,44,36,34,42,-1
07.10.2025,2025,rus,145,Dynamo Vladivostok,x,66,73,20,27,19,13,14,22,13,11,47,32,36,24,-1
07.10.2025,2025,rus,145,Irkutsk,x,71,90,17,18,13,27,24,20,17,25,35,40,44,42,1
10.10.2025,2025,eurolig,168,Partizan,x,93,86,24,24,26,23,18,17,25,22,48,49,35,47,-1
10.10.2025,2025,eurolig,161,Bayern,x,94,79,25,16,22,18,19,24,28,21,41,40,43,49,1
10.10.2025,2025,eurolig,160,Virtus Bologna,x,87,85,38,27,19,22,16,21,14,15,65,41,37,29,-1
10.10.2025,2025,eurolig,162,Fenerbahce,x,78,83,21,27,16,19,14,14,27,23,48,35,28,50,-1
09.10.2025,2025,eurolig,165,Baskonia,x,78,71,25,20,17,14,17,15,19,22,45,31,32,41,-1
09.10.2025,2025,eurolig,164,Maccabi Tel Aviv,x,85,79,21,23,20,23,24,14,20,19,44,43,38,39,-1
04.10.2025,2025,eurolig,163,Crvena zvezda,x,77,80,18,17,25,18,15,23,19,22,35,43,38,41,-1
04.10.2025,2025,eurolig,162,Anadolu Efes,x,67,76,21,15,15,21,16,15,15,25,36,36,31,40,-1
04.10.2025,2025,eurolig,159,Olympiacos,x,82,71,17,13,15,23,25,20,25,15,30,38,45,40,1
03.10.2025,2025,eurolig,164,Lyon-Villeurbanne,x,89,82,24,31,27,21,20,19,18,11,55,48,39,29,-1
03.10.2025,2025,eurolig,161,Real Madrid,x,97,89,26,29,26,22,12,22,33,16,55,48,34,49,1
03.10.2025,2025,eurolig,167,Partizan,x,88,82,16,17,16,21,27,22,29,22,33,37,49,51,1
03.10.2025,2025,eurolig,153,Olimpia Milano,x,93,80,22,10,25,16,19,23,27,31,32,41,42,58,1
03.10.2025,2025,eurolig,160,Barcelona,x,74,67,21,14,22,17,7,17,24,19,35,39,24,43,-1
03.10.2025,2025,eurolig,162,Panathinaikos,x,77,87,17,26,19,19,21,17,20,25,43,38,38,45,1
09.10.2025,2025,aba 2,151,MZT Skopje,x,77,75,22,24,14,22,17,13,15,9,46,36,30,24,-1
09.10.2025,2025,aba 2,150,Tivat,x,69,62,16,14,12,20,21,12,20,16,30,32,33,36,-1
09.10.2025,2025,aba 2,151,Sutjeska,x,78,74,26,18,19,15,16,19,17,22,44,34,35,39,-1
08.10.2025,2025,aba 2,156,Rabotnicki,x,93,62,28,20,19,18,26,12,20,12,48,37,38,32,-1
10.10.2025,2025,lat nkl,154,Neptunas 2,x,63,68,18,20,14,18,17,19,14,11,38,32,36,25,-1
10.10.2025,2025,lat nkl,155,Zalgiris Kaunas 2,x,65,90,10,24,11,21,21,21,23,24,34,32,42,47,1
10.10.2025,2025,lat nkl,166,Vytis VDU,x,88,95,16,15,26,23,17,31,29,26,31,49,48,55,1
10.10.2025,2025,lat nkl,162,Rytas 2,x,93,68,25,23,20,12,25,19,23,14,48,32,44,37,-1
10.10.2025,2025,lat nkl,160,Vilkaviskis,x,82,92,16,24,30,22,18,28,18,18,40,52,46,36,1
10.10.2025,2025,lat nkl,164,Delikatesas Joniskis,x,93,65,24,13,27,16,26,17,16,19,37,43,43,35,-1
10.10.2025,2025,lat nkl,157,Plunges Olimpas,x,81,76,16,25,22,13,19,21,24,17,41,35,40,41,1
10.10.2025,2025,lat nkl,161,Jurbarkas,x,74,97,14,35,19,18,18,24,23,20,49,37,42,43,1
05.10.2025,2025,lat nkl,158,Kretinga,x,87,86,22,17,14,19,28,26,23,24,39,33,54,47,1
05.10.2025,2025,lat nkl,163,Rytas 2,x,70,80,21,32,20,20,16,16,13,12,53,40,32,25,-1
05.10.2025,2025,lat nkl,156,Suduva-Mantinga,x,87,81,17,19,16,20,21,21,33,21,36,36,42,54,1
05.10.2025,2025,lat nkl,150,Ukmerges Stekas,x,73,93,26,22,16,28,11,21,20,22,48,44,32,42,-1
05.10.2025,2025,lat nkl,162,Omega-Tauras,x,75,85,27,22,15,16,13,21,20,26,49,31,34,46,-1
05.10.2025,2025,lat nkl,164,BC Olimpas Palanga,x,90,85,20,26,25,21,23,13,22,25,46,46,36,47,1
05.10.2025,2025,lat nkl,148,Telsiai,x,63,76,16,14,16,15,13,24,18,23,30,31,37,41,1
05.10.2025,2025,lat nkl,164,Alytaus Alytus,x,75,73,16,21,23,17,16,18,20,17,37,40,34,37,-1
10.10.2025,2025,tur b,167,Konya BBSK,x,97,83,20,7,19,29,32,26,26,21,27,48,58,47,1
10.10.2025,2025,tur b,157,Bordo Sportif,x,81,77,18,24,21,17,16,19,20,15,42,38,35,35,-1
10.10.2025,2025,tur b,,Final Spor,x,70,66,18,13,8,16,19,22,25,15,31,24,41,40,
09.10.2025,2025,tur b,153,Istanbul Anka Spor,x,100,60,22,17,29,11,23,19,26,13,39,40,42,39,1
09.10.2025,2025,tur b,151,iLab Basketbol,x,80,75,10,18,18,19,25,19,27,19,28,37,44,46,1
09.10.2025,2025,tur b,155,OGM Ormanspor,x,84,61,33,11,12,18,22,16,17,16,44,30,38,33,-1
09.10.2025,2025,tur b,162,Cayirova,x,77,80,27,24,9,10,20,23,21,23,51,19,43,44,1
09.10.2025,2025,tur b,155,Ankara Kolejliler,x,52,61,8,15,17,10,12,15,15,21,23,27,27,36,-1
09.10.2025,2025,tur b,152,Esenler Erokspor,x,70,88,19,20,10,22,21,24,20,22,39,32,45,42,1
07.10.2025,2025,tur b,161,Kapakli Spor,x,83,61,20,12,23,20,23,15,17,14,32,43,38,31,-1
10.10.2025,2025,pol,170,Torun,x,68,79,16,26,14,22,21,15,17,16,42,36,36,33,-1
09.10.2025,2025,pol,166,Slask Wroclaw,x,81,100,19,25,22,20,24,26,16,29,44,42,50,45,1
09.10.2025,2025,cek,154,Pardubice,x,89,82,22,21,17,24,25,15,25,22,43,41,40,47,1
09.10.2025,2025,cek,170,Olomoucko,x,63,77,16,22,12,20,22,16,13,19,38,32,38,32,-1
09.10.2025,2025,cek,171,Usti n. Labem,x,72,87,10,21,16,18,18,18,28,30,31,34,36,58,1
09.10.2025,2025,cek,168,Slavia Prague,x,81,66,19,11,33,21,11,13,18,21,30,54,24,39,-1
09.10.2025,2025,cek,162,Opava,x,86,78,22,29,18,15,23,12,23,22,51,33,35,45,-1
09.10.2025,2025,eurocup,158,Bahcesehir Kol.,x,66,63,16,10,16,17,16,22,18,14,26,33,38,32,-1
09.10.2025,2025,eurocup,165,Buducnost,x,64,85,16,18,19,24,9,23,20,20,34,43,32,40,-1
09.10.2025,2025,eurocup,171,Hamburg,x,89,74,21,18,25,19,13,17,30,20,39,44,30,50,-1
09.10.2025,2025,eurocup,163,Joventut Badalona,x,73,78,18,19,19,21,21,15,15,23,37,40,36,38,-1
09.10.2025,2025,eurocup,167,Valencia,x,96,105,24,19,28,25,23,26,21,35,43,53,49,56,1
08.10.2025,2025,eurocup,166,Hapoel Tel-Aviv,x,87,101,22,24,19,30,21,27,25,20,46,49,48,45,1
08.10.2025,2025,eurocup,159,JL Bourg,x,66,88,17,17,19,27,17,32,13,12,34,46,49,25,-1
08.10.2025,2025,eurocup,159,Cedevita Olimpija,x,78,70,26,22,17,15,14,15,21,18,48,32,29,39,-1
08.10.2025,2025,eurocup,170,Ulm,x,76,94,20,21,21,24,25,23,10,26,41,45,48,36,-1
08.10.2025,2025,eurocup,151,Aris,x,74,92,16,19,16,23,23,28,19,22,35,39,51,41,1
09.10.2025,2025,fiba,162,Szczecin,x,83,60,17,21,21,14,22,15,23,10,38,35,37,33,-1
09.10.2025,2025,fiba,160,Manisa,x,97,101,20,17,24,31,26,21,27,32,37,55,47,59,1
09.10.2025,2025,fiba,162,Promitheas,x,86,88,16,29,25,21,30,24,15,14,45,46,54,29,1
09.10.2025,2025,fiba,162,Oostende,x,77,74,21,25,21,16,15,13,20,20,46,37,28,40,-1
08.10.2025,2025,fiba,162,Nanterre,x,70,76,20,24,14,11,15,21,21,20,44,25,36,41,-1
08.10.2025,2025,fiba,168,Nymburk,x,75,87,13,23,24,23,20,20,18,21,36,47,40,39,-1
08.10.2025,2025,fiba,157,Murcia,x,76,81,22,24,13,18,20,16,21,23,46,31,36,44,1
08.10.2025,2025,fiba,156,Igokea,x,98,80,21,23,20,18,33,17,24,22,44,38,50,46,1
09.10.2025,2025,fiba euro,154,Szolnoki Olaj,x,77,68,20,16,18,10,19,23,20,19,36,28,42,39,1
09.10.2025,2025,fiba euro,152,PAOK,x,70,74,21,21,21,14,16,14,12,25,42,35,30,37,-1
09.10.2025,2025,fiba euro,152,Sabah Baku,x,82,81,24,26,25,16,18,20,15,19,50,41,38,34,-1
09.10.2025,2025,fiba euro,161,Bursaspor,x,106,84,26,25,26,13,28,19,26,27,51,39,47,53,1
09.10.2025,2025,fiba euro,159,AEK Larnaca,x,89,59,12,21,20,11,29,15,28,12,33,31,44,40,1
09.10.2025,2025,fiba euro,161,Balkan,x,95,55,27,16,17,13,18,17,33,9,43,30,35,42,-1
09.10.2025,2025,fiba euro,157,Trepca,x,118,73,34,27,28,12,28,15,28,19,61,40,43,47,1
09.10.2025,2025,fiba euro,155,Antwerp Giants,x,70,88,16,31,15,17,18,25,21,15,47,32,43,36,1
09.10.2025,2025,fiba euro,165,Norrkoping,x,99,80,14,19,30,24,24,19,31,18,33,54,43,49,1
09.10.2025,2025,fiba euro,173,Kutaisi,x,77,69,17,18,20,22,24,12,16,17,35,42,36,33,-1
09.10.2025,2025,fiba euro,166,Keravnos,x,99,81,30,15,19,14,16,33,34,19,45,33,49,53,1
09.10.2025,2025,fiba euro,155,Le Portel,x,66,63,14,13,24,16,14,17,14,17,27,40,31,31,-1
09.10.2025,2025,fiba euro,175,Rilski Sportist,x,100,88,30,17,22,20,33,21,15,30,47,42,54,45,1
09.10.2025,2025,fiba euro,158,BC Dnipro,x,114,71,32,20,28,18,23,19,31,14,52,46,42,45,1
09.10.2025,2025,fiba euro,151,Parnu,x,67,65,25,17,15,17,15,19,12,12,42,32,34,24,-1
09.10.2025,2025,fiba euro,158,Spojnia Stargard,x,77,75,20,16,16,28,22,10,19,21,36,44,32,40,-1
08.10.2025,2025,fiba euro,161,Fribourg Olympic,x,90,75,27,17,20,22,21,15,22,21,44,42,36,43,-1
08.10.2025,2025,fiba euro,159,Sassari,x,69,82,14,32,25,16,13,27,17,7,46,41,40,24,-1
08.10.2025,2025,fiba euro,161,Caledonia Gladiators,x,86,62,21,14,15,12,23,17,27,19,35,27,40,46,1
08.10.2025,2025,fiba euro,158,Levice,x,72,83,19,22,19,16,18,18,16,27,41,35,36,43,-1
09.10.2025,2025,aba,157,KK Krka Novo mesto,x,74,81,24,20,17,20,23,19,10,22,44,37,42,32,-1
07.10.2025,2025,aba,152,Zadar,x,86,62,19,15,21,15,24,18,22,14,34,36,42,36,1
09.10.2025,2025,lat-st,170,Keila Coolbet,x,86,82,17,22,15,20,26,23,28,17,39,35,49,45,1
09.10.2025,2025,lat-st,158,Viimsi,x,89,52,21,10,18,11,28,10,22,21,31,29,38,43,1
08.10.2025,2025,lat-st,168,Keila KK,x,116,78,31,15,23,15,33,22,29,26,46,38,55,55,1
09.10.2025,2025,fin,160,Helsinki Seagulls,x,80,78,20,12,18,24,21,20,21,22,32,42,41,43,1
09.10.2025,2025,fin,162,BC Nokia,x,92,74,18,22,31,15,19,19,24,18,40,46,38,42,-1
09.10.2025,2025,fin,167,Kobrat,x,89,81,25,22,14,20,26,21,24,18,47,34,47,42,1
09.10.2025,2025,fin,164,Pyrinto Tampere,x,83,76,20,23,19,17,16,20,28,16,43,36,36,44,-1
08.10.2025,2025,fin,173,Honka,x,77,91,20,21,18,27,18,20,21,23,41,45,38,44,-1
08.10.2025,2025,fin,165,Bisons Loimaa,x,71,74,17,21,24,13,18,19,12,21,38,37,37,33,-1
08.10.2025,2025,fin,171,KTP Kotka Basket,x,94,87,23,16,13,28,20,15,23,20,39,41,35,43,-1
09.10.2025,2025,mac,162,Szedeak,x,70,74,22,18,17,18,16,18,15,20,40,35,34,35,-1
09.10.2025,2025,mac,165,Atomeromu Paks,x,81,103,12,25,18,27,25,29,26,22,37,45,54,48,1
09.10.2025,2025,mac,172,Kormend,x,91,81,28,19,25,21,16,19,22,22,47,46,35,44,-1
09.10.2025,2025,mac,164,Soproni KC,x,108,85,29,17,23,18,24,17,32,33,46,41,41,65,1
08.10.2025,2025,mac,,NKA Pecs,x,79,84,22,14,14,23,22,23,21,24,36,37,45,45,
05.10.2025,2025,mac,158,Szombathely,x,67,98,17,29,19,22,11,20,20,27,46,41,31,47,-1
05.10.2025,2025,mac,170,Pecsi VSK,x,91,84,19,26,25,20,26,22,21,16,45,45,48,37,-1
05.10.2025,2025,mac,165,Zalakeramia,x,83,78,13,24,23,23,24,16,23,15,37,46,40,38,-1
05.10.2025,2025,mac,160,Soproni KC,x,81,70,20,14,18,16,23,19,20,21,34,34,42,41,1
09.10.2025,2025,ita b,152,Brindisi,x,75,57,20,8,25,17,15,17,15,15,28,42,32,30,-1
09.10.2025,2025,ita b,155,Orzinuovi,x,80,75,25,23,19,22,20,23,16,7,48,41,43,23,-1
10.10.2025,2025,lat cup,176,Siauliai,x,87,84,21,22,22,18,21,24,23,20,43,40,45,43,-1
09.10.2025,2025,lat cup,167,Mazeikiai,x,106,71,25,19,27,15,32,24,22,13,44,42,56,35,1
09.10.2025,2025,lat cup,170,Nevezis,x,87,74,24,19,22,20,17,18,24,17,43,42,35,41,-1
02.10.2025,2025,lat cup,166,Neptunas,x,102,82,18,17,20,26,29,23,35,16,35,46,52,51,1
02.10.2025,2025,lat cup,173,Nevezis,x,93,80,16,18,19,22,32,15,26,25,34,41,47,51,1
02.10.2025,2025,lat cup,158,Juventus,x,73,86,15,28,27,19,17,20,14,19,43,46,37,33,-1
09.10.2025,2025,vtb,158,Nizhny Novgorod,x,81,78,21,22,21,19,27,14,12,23,43,40,41,35,-1
09.10.2025,2025,vtb,153,Parma Perm,x,56,63,12,19,11,19,6,9,27,16,31,30,15,43,-1
09.10.2025,2025,slovak,173,Inter Bratislava,x,75,91,18,24,15,11,18,33,24,23,42,26,51,47,1
05.10.2025,2025,slovak,164,BC Komarno,x,78,102,16,32,23,20,14,28,25,22,48,43,42,47,1
05.10.2025,2025,slovak,165,BC Prievidza,x,85,104,24,26,14,31,22,27,25,20,50,45,49,45,1
05.10.2025,2025,slovak,162,Nitra Blue Wings,x,76,66,18,16,21,16,9,13,28,21,34,37,22,49,-1
05.10.2025,2025,slovak,172,SPU Nitra,x,122,101,32,13,36,20,29,39,25,29,45,56,68,54,1
05.10.2025,2025,slovak,164,Inter Bratislava,x,99,82,24,27,31,22,25,17,19,16,51,53,42,35,-1
10.10.2025,2025,kore,166,LG Sakers,x,92,88,15,33,39,12,24,19,14,24,48,51,43,38,-1
09.10.2025,2025,kore,167,Anyang JungKwanJang,x,92,70,30,21,16,12,27,14,19,23,51,28,41,42,-1
09.10.2025,2025,kore,161,KoGas,x,73,88,23,22,23,24,16,18,11,24,45,47,34,35,-1
10.10.2025,2025,tur b,166,Konya BBSK,x,97,83,20,7,19,29,32,26,26,21,27,48,58,47,1
10.10.2025,2025,tur b,156,Bordo Sportif,x,81,77,18,24,21,17,16,19,20,15,42,38,35,35,-1
10.10.2025,2025,tur b,153,Final Spor,x,70,66,18,13,8,16,19,22,25,15,31,24,41,40,1
09.10.2025,2025,tur b,153,Istanbul Anka Spor,x,100,60,22,17,29,11,23,19,26,13,39,40,42,39,1
09.10.2025,2025,tur b,151,iLab Basketbol,x,80,75,10,18,18,19,25,19,27,19,28,37,44,46,1
09.10.2025,2025,tur b,155,OGM Ormanspor,x,84,61,33,11,12,18,22,16,17,16,44,30,38,33,-1
09.10.2025,2025,tur b,163,Cayirova,x,77,80,27,24,9,10,20,23,21,23,51,19,43,44,1
09.10.2025,2025,tur b,156,Ankara Kolejliler,x,52,61,8,15,17,10,12,15,15,21,23,27,27,36,-1
09.10.2025,2025,tur b,152,Esenler Erokspor,x,70,88,19,20,10,22,21,24,20,22,39,32,45,42,1
07.10.2025,2025,tur b,161,Kapakli Spor,x,83,61,20,12,23,20,23,15,17,14,32,43,38,31,-1
05.10.2025,2025,sloven,158,Ilirija,x,91,100,24,17,22,24,15,28,25,17,41,46,43,42,1
05.10.2025,2025,sloven,155,Zlatorog Lasko,x,94,66,23,27,23,13,18,13,30,13,50,36,31,43,-1
05.10.2025,2025,sloven,157,LTH Castings,x,75,73,17,17,20,14,17,16,21,26,34,34,33,47,1
12.10.2025,2025,por b,152,Braga,Maia,94,75,28,21,20,13,19,24,27,17,49,33,43,44,1
12.10.2025,2025,por b,149,Vasco Da Gama,Galitos Aveiro,71,67,20,15,17,24,18,18,16,10,35,41,36,26,-1
12.10.2025,2025,por b,143,Illiabum,Sangalhos,74,50,21,18,24,6,15,17,14,9,39,30,32,23,-1
12.10.2025,2025,por b,150,CAB Madeira,Barreirense,55,62,22,20,15,18,9,14,9,10,42,33,23,19,-1
12.10.2025,2025,por b,149,Ginasio,Sampaense,78,72,15,18,18,14,26,30,19,10,33,32,56,29,1
12.10.2025,2025,por b,149,Santo Andre,Lusitania,50,44,10,3,5,6,14,20,21,15,13,11,34,36,-1
05.10.2025,2025,por b,156,Galitos Aveiro,Ginasio,70,59,22,8,13,13,22,12,13,26,30,26,34,39,-1
05.10.2025,2025,por b,,Lusitania,Benfica Lisboa B,60,59,14,17,16,20,14,7,16,15,31,36,21,31,
05.10.2025,2025,por b,153,Barreirense,Imortal B,69,81,19,23,18,16,18,19,14,23,42,34,37,37,-1
05.10.2025,2025,por b,150,Maia,Illiabum,65,78,16,19,13,24,17,19,19,16,35,37,36,35,-1
05.10.2025,2025,por b,,Portimonense,Santo Andre,60,53,12,11,16,15,16,17,16,10,23,31,33,26,
05.10.2025,2025,por b,153,Sangalhos,Vasco Da Gama,71,81,17,18,20,16,17,17,17,30,35,36,34,47,1
05.10.2025,2025,por b,149,Sampaense,Braga,65,81,20,16,14,17,15,24,16,24,36,31,39,40,1
05.10.2025,2025,por b,,CB Queluz,CAB Madeira,55,65,11,17,21,10,8,25,15,13,28,31,33,28,
12.10.2025,2025,por b,152,Maia,x,94,75,28,21,20,13,19,24,27,17,49,33,43,44,1
12.10.2025,2025,por b,149,Galitos Aveiro,x,71,67,20,15,17,24,18,18,16,10,35,41,36,26,-1
12.10.2025,2025,por b,143,Sangalhos,x,74,50,21,18,24,6,15,17,14,9,39,30,32,23,-1
12.10.2025,2025,por b,150,Barreirense,x,55,62,22,20,15,18,9,14,9,10,42,33,23,19,-1
12.10.2025,2025,por b,149,Sampaense,x,78,72,15,18,18,14,26,30,19,10,33,32,56,29,1
12.10.2025,2025,por b,149,Lusitania,x,50,44,10,3,5,6,14,20,21,15,13,11,34,36,-1
05.10.2025,2025,por b,156,Ginasio,x,70,59,22,8,13,13,22,12,13,26,30,26,34,39,-1
05.10.2025,2025,por b,,Benfica Lisboa B,x,60,59,14,17,16,20,14,7,16,15,31,36,21,31,-1
05.10.2025,2025,por b,153,Imortal B,x,69,81,19,23,18,16,18,19,14,23,42,34,37,37,-1
05.10.2025,2025,por b,150,Illiabum,x,65,78,16,19,13,24,17,19,19,16,35,37,36,35,-1
05.10.2025,2025,por b,,Santo Andre,x,60,53,12,11,16,15,16,17,16,10,23,31,33,26,
05.10.2025,2025,por b,153,Vasco Da Gama,x,71,81,17,18,20,16,17,17,17,30,35,36,34,47,1
05.10.2025,2025,por b,149,Braga,x,65,81,20,16,14,17,15,24,16,24,36,31,39,40,1
05.10.2025,2025,por b,,CAB Madeira,x,55,65,11,17,21,10,8,25,15,13,28,31,33,28,
13.10.2025,2025,avst,183,Melbourne United,Adelaide,106,79,24,29,34,23,21,8,27,19,53,57,29,46,-1
13.10.2025,2025,avst,180,Sydney,Cairns Taipans,99,73,28,18,25,21,23,18,23,16,46,46,41,39,-1
12.10.2025,2025,avst,183,South East Melbourne,Brisbane Bullets,85,87,23,18,26,27,17,23,19,19,41,53,40,38,-1
12.10.2025,2025,avst,175,Illawarra Hawks,Tasmania JackJumpers,109,76,32,17,25,22,27,13,25,24,49,47,40,49,1
11.10.2025,2025,avst,188,Adelaide,Sydney,89,79,26,22,23,15,19,25,21,17,48,38,44,38,-1
10.10.2025,2025,avst,183,Cairns Taipans,Perth,87,90,23,29,18,19,26,27,20,15,52,37,53,35,-1
13.10.2025,2025,bul,164,Cherno More,Balkan,75,80,18,20,13,20,19,24,25,16,38,33,43,41,1
12.10.2025,2025,bul,163,Levski,Shumen,96,91,20,21,28,19,20,18,28,33,41,47,38,61,1
12.10.2025,2025,bul,160,Minyor,Rilski Sportist,75,87,14,26,26,17,18,21,17,23,40,43,39,40,-1
13.10.2025,2025,cin,200,Xinjiang,Jiangsu Dragons,112,98,28,29,29,28,27,23,28,18,57,57,50,46,-1
13.10.2025,2025,cin,207,Beijing,Shanghai,110,107,26,29,25,30,26,25,24,17,55,55,51,41,-1
13.10.2025,2025,cin,216,Jilin,Beijing Royal Fighters,99,100,24,29,32,21,26,21,17,29,53,53,47,46,-1
13.10.2025,2025,cin,217,Nanjing Tongxi,Shenzhen,104,91,31,21,20,26,27,22,26,22,52,46,49,48,-1
13.10.2025,2025,cin,212,Ningbo Rockets,Sichuan,126,114,28,23,27,38,35,27,36,26,51,65,62,62,1
13.10.2025,2025,cin,205,Shandong,Zhejiang Guangsha,102,113,22,27,23,35,24,29,33,22,49,58,53,55,1
13.10.2025,2025,cin,226,Shanxi Zhongyu,Guangdong,110,99,23,29,39,22,23,27,25,21,52,61,50,46,-1
12.10.2025,2025,cin,207,Liaoning,Zhejiang Chouzhou,123,112,31,33,21,28,42,21,29,30,64,49,63,59,1
13.10.2025,2025,kıbrıs,155,Keravnos,ETHA Engomi,107,96,30,23,32,20,25,24,20,29,53,52,49,49,1
12.10.2025,2025,kıbrıs,155,Apoel BC,Paralimni,89,71,21,25,23,20,26,12,19,14,46,43,38,33,-1
11.10.2025,2025,kıbrıs,156,AEL,Apollon,105,79,31,23,21,21,23,22,30,13,54,42,45,43,1
13.10.2025,2025,cek,161,Usti n. Labem,USK Prague,87,57,29,8,22,10,19,21,17,18,37,32,40,35,-1
12.10.2025,2025,cek,173,Olomoucko,Srsni Pisek,103,107,25,17,26,23,18,21,27,35,42,49,39,62,1
12.10.2025,2025,cek,164,Opava,Decin,89,92,19,17,25,22,26,19,19,34,36,47,45,53,1
12.10.2025,2025,cek,160,Slavia Prague,Jindrichuv Hradec,91,67,23,17,21,14,22,15,25,21,40,35,37,46,1
12.10.2025,2025,cek,169,Pardubice,NH Ostrava,83,90,19,23,20,26,13,23,31,18,42,46,36,49,1
12.10.2025,2025,cek,163,Nymburk,Brno,102,82,18,26,25,10,33,22,26,24,44,35,55,50,1
13.10.2025,2025,bnxt,159,QSTA Utd,Spirou Charleroi,77,87,22,24,20,20,13,23,22,20,46,40,36,42,-1
12.10.2025,2025,bnxt,158,Belfius Mons,Den Bosch,78,84,16,29,23,15,26,23,13,17,45,38,49,30,-1
12.10.2025,2025,bnxt,155,Leuven Bears,LWD Basket,85,48,23,11,20,11,18,9,24,17,34,31,27,41,-1
12.10.2025,2025,bnxt,153,Leiden,Okapi Aalst,79,67,30,17,17,10,18,23,14,17,47,27,41,31,-1
12.10.2025,2025,bnxt,148,Den Helder,Circus Brussels,73,93,14,18,12,32,24,22,23,21,32,44,46,44,1
12.10.2025,2025,bnxt,158,Donar Groningen,BAL Weert,72,62,22,11,12,22,21,18,17,11,33,34,39,28,-1
11.10.2025,2025,bnxt,163,Kortrijk,Mechelen,108,85,22,21,29,24,31,17,26,23,43,53,48,49,1
13.10.2025,2025,lat-st,149,Viimsi,Rapla,80,85,21,26,25,22,20,14,14,23,47,47,34,37,-1
12.10.2025,2025,lat-st,171,Rigas Zelli,Keila Coolbet,87,80,27,17,18,21,15,23,27,19,44,39,38,46,-1
12.10.2025,2025,lat-st,171,Keila KK,BK Ogre,83,96,21,18,17,35,19,16,26,27,39,52,35,53,1
12.10.2025,2025,lat-st,160,Tal Tech,BK Liepaja,100,97,28,27,25,17,23,31,24,22,55,42,54,46,1
12.10.2025,2025,lat-st,151,VEF Riga,Tartu Ulikool,74,71,20,24,19,13,15,13,20,21,44,32,28,41,-1
12.10.2025,2025,lat-st,152,Parnu,Latvijas Universitate,77,53,22,8,16,10,28,10,11,25,30,26,38,36,-1
11.10.2025,2025,lat-st,154,BC Kalev/Cramo,BK Liepaja,90,74,20,20,24,11,24,28,22,15,40,35,52,37,1
11.10.2025,2025,lat-st,150,Valmiera Glass Via,Rapla,80,65,14,13,23,18,17,19,26,15,27,41,36,41,1
13.10.2025,2025,ger b,161,Jena,Munster,87,83,18,24,19,27,21,18,29,14,42,46,39,43,1
12.10.2025,2025,ger b,176,Artland,Vechta 2,99,62,24,25,24,5,30,22,21,10,49,29,52,31,-1
12.10.2025,2025,ger b,153,Koblenz,Kirchheim,80,87,22,16,17,20,20,22,21,29,38,37,42,50,1
12.10.2025,2025,ger b,159,Tubingen,Dusseldorf,92,84,22,28,19,23,19,16,32,17,50,42,35,49,1
12.10.2025,2025,ger b,156,Bochum,Nurnberger,68,55,17,17,19,9,21,14,11,15,34,28,35,26,-1
12.10.2025,2025,ger b,176,Giessen,Bayreuth,98,74,18,14,34,18,22,21,24,21,32,52,43,45,-1
12.10.2025,2025,ger b,164,Phoenix Hagen,PS Karlsruhe,100,69,30,16,20,18,23,18,27,17,46,38,41,44,1
12.10.2025,2025,ger b,171,Bremerhaven,Dresden,98,72,20,19,34,15,18,18,26,20,39,49,36,46,-1
13.10.2025,2025,ger,165,Bonn,Bayern,85,91,26,19,20,22,15,29,24,21,45,42,44,45,1
13.10.2025,2025,ger,173,Crailsheim Merlins,Alba Berlin,74,75,26,17,17,11,19,22,12,25,43,28,41,37,-1
13.10.2025,2025,ger,157,Ludwigsburg,Syntainics MBC,77,85,22,10,21,29,17,20,17,26,32,50,37,43,1
13.10.2025,2025,ger,169,Heidelberg,Chemnitz,78,73,19,10,23,25,15,15,21,23,29,48,30,44,-1
12.10.2025,2025,ger,164,Basketball Braunschweig,Vechta,68,89,16,26,20,22,17,21,15,20,42,42,38,35,-1
12.10.2025,2025,ger,166,Bamberg,Ulm,103,100,21,31,25,20,25,18,32,31,52,45,43,63,1
12.10.2025,2025,ger,162,Frankfurt,Oldenburg,85,79,19,16,24,10,21,16,21,37,35,34,37,58,1
11.10.2025,2025,ger,165,Gottingen,Wurzburg,86,78,23,18,17,18,17,23,29,19,41,35,40,48,1
13.10.2025,2025,mac,163,Szedeak,Szombathely,82,87,26,22,18,22,12,25,26,18,48,40,37,44,-1
12.10.2025,2025,mac,160,DEAC,Pecsi VSK,75,68,21,13,14,14,22,21,18,20,34,28,43,38,1
12.10.2025,2025,mac,173,NKA Pecs,Alba Fehervar,79,70,19,21,19,22,18,9,23,18,40,41,27,41,-1
12.10.2025,2025,mac,158,OSE Lions,KTE-Duna,94,62,20,14,17,18,23,12,34,18,34,35,35,52,1
12.10.2025,2025,mac,158,Soproni KC,Szolnoki Olaj,71,75,22,14,15,18,11,18,23,25,36,33,29,48,-1
12.10.2025,2025,mac,160,Zalakeramia,Budapesti Honved Se,104,85,31,19,27,30,23,16,23,20,50,57,39,43,1
12.10.2025,2025,mac,171,Atomeromu Paks,Kormend,88,76,25,13,24,15,18,28,21,20,38,39,46,41,1
13.10.2025,2025,ita b,149,Brindisi,Forli,82,63,20,9,25,19,18,19,19,16,29,44,37,35,-1
13.10.2025,2025,ita b,151,Cantu,Basket Torino,72,68,16,14,20,23,21,17,15,14,30,43,38,29,-1
13.10.2025,2025,ita b,152,Nardo,Libertas Livorno,82,71,20,14,21,17,22,25,19,15,34,38,47,34,1
13.10.2025,2025,ita b,160,Orzinuovi,Assigeco Piacenza,87,81,34,22,22,17,20,24,11,18,56,39,44,29,-1
13.10.2025,2025,ita b,157,Rimini,Urania Milano,84,76,27,24,10,19,17,17,30,16,51,29,34,46,1
13.10.2025,2025,ita b,154,Verona,Cividale,82,72,23,21,17,18,20,14,22,19,44,35,34,41,-1
12.10.2025,2025,ita b,153,Sebastiani Rieti,Pesaro,86,80,24,20,17,17,21,20,24,23,44,34,41,47,1
12.10.2025,2025,ita b,150,Avellino Basket,Vigevano,85,80,24,18,18,22,20,18,23,22,42,40,38,45,1
12.10.2025,2025,ita b,156,JuVi Cremona,Fortitudo Bologna,70,79,14,24,23,20,22,15,11,20,38,43,37,31,-1
11.10.2025,2025,ita b,151,Udine,Cento,87,69,27,13,14,20,27,17,19,19,40,34,44,38,1
13.10.2025,2025,lat lkl,174,Siauliai,Nevezis,95,91,31,18,19,27,19,29,26,17,49,46,48,43,1
13.10.2025,2025,lat lkl,166,Mazeikiai,Juventus,46,91,17,21,17,21,6,26,6,23,38,38,32,29,-1
12.10.2025,2025,lat lkl,172,Neptunas,BC Wolves,89,74,25,23,18,19,29,15,17,17,48,37,44,34,-1
12.10.2025,2025,lat lkl,169,Lietkabelis,Rytas,67,84,19,21,13,29,17,20,18,14,40,42,37,32,-1
13.10.2025,2025,mak,,Feniks 2010,Cair 2030,73,93,19,20,19,20,20,26,15,27,39,39,46,42,1
13.10.2025,2025,mak,,Kozuv,Vardar,87,75,27,15,17,21,20,18,23,21,42,38,38,44,1
12.10.2025,2025,mak,,Shkupi Skopje,Rabotnicki,73,81,29,26,10,25,18,14,16,16,55,35,32,32,1
12.10.2025,2025,mak,,Pelister,MZT Skopje,68,67,19,21,20,13,16,20,13,13,40,33,36,26,
12.10.2025,2025,mak,,Gostivar,TFT Skopje,60,61,9,4,22,20,15,17,14,20,13,42,32,34,1
12.10.2025,2025,mak,,MKK Kumanovo,Tikvesh,93,89,17,19,13,18,21,18,28,24,36,31,39,52,1
13.10.2025,2025,pol,159,Trefl Sopot,Spojnia Stargard,83,78,20,24,24,20,18,22,21,12,44,44,40,33,-1
12.10.2025,2025,pol,157,Dabrowa Gornicza,Gornik Walbrzych,74,79,16,22,28,19,19,12,11,26,38,47,31,37,-1
12.10.2025,2025,pol,160,Anwil Wloclawek,Dziki Warszawa,79,70,29,19,10,16,20,17,20,18,48,26,37,38,-1
11.10.2025,2025,pol,167,Lublin,Legia,78,89,24,15,19,29,24,24,11,21,39,48,48,32,-1
11.10.2025,2025,pol,159,Ostrow Wielkopolski,Czarni Slupsk,70,66,27,15,15,21,13,20,15,10,42,36,33,25,-1
13.10.2025,2025,rom,160,BC Steaua Bucuresti,CSM Constanta,83,82,21,20,22,22,24,20,16,20,41,44,44,36,-1
13.10.2025,2025,rom,168,Municipal Galati,CSU Sibiu,83,92,23,22,21,18,20,27,19,25,45,39,47,44,1
12.10.2025,2025,rom,162,Cluj-Napoca,Arges Pitesti,81,67,16,6,26,16,18,23,21,22,22,42,41,43,1
12.10.2025,2025,rom,150,SCM Craiova,Corona Brasov,76,78,21,17,17,29,21,9,17,23,38,46,30,40,-1
12.10.2025,2025,rom,157,Valcea,Rapid Bucuresti,68,72,23,23,18,13,13,18,14,18,46,31,31,32,-1
12.10.2025,2025,rom,160,CSM Oradea,Voluntari,93,66,21,16,22,14,30,19,20,17,37,36,49,37,1
12.10.2025,2025,rom,162,Petrolul Ploiesti,CSM Targu Mures,76,102,28,19,20,33,16,31,12,19,47,53,47,31,-1
11.10.2025,2025,rom,154,BC Timisoara,Dinamo Bucharest,84,70,13,19,24,18,25,16,22,17,32,42,41,39,1
13.10.2025,2025,vtb,163,CSKA Moscow,Zenit Petersburg,83,77,22,14,24,27,21,19,16,17,36,51,40,33,-1
12.10.2025,2025,vtb,155,Unics Kazan,Saratov,84,54,29,9,19,10,21,21,15,14,38,29,42,29,-1
12.10.2025,2025,vtb,168,Lokomotiv Kuban,Samara,76,64,22,22,14,18,14,15,26,9,44,32,29,35,-1
12.10.2025,2025,vtb,152,Enisey,Uralmash Ekaterinburg,66,101,11,26,24,29,11,21,20,25,37,53,32,45,1
12.10.2025,2025,vtb,152,Astana,MBA Moscow,63,76,18,20,15,15,21,20,9,21,38,30,41,30,-1
13.10.2025,2025,sır,157,Vojvodina Novi Sad,Dynamic,103,66,32,15,25,21,26,15,20,15,47,46,41,35,-1
12.10.2025,2025,sır,154,Radnicki,Cacak 94,61,77,16,20,8,16,15,17,22,24,36,24,32,46,1
12.10.2025,2025,sır,166,KK Metalac,Zlatibor,76,88,14,28,22,24,15,24,25,12,42,46,39,37,-1
12.10.2025,2025,sır,161,Sloga,Tamis,78,79,20,20,13,25,26,14,19,20,40,38,40,39,-1
12.10.2025,2025,sır,166,BBK Radnicki,OKK Beograd,89,93,20,22,23,23,19,26,27,22,42,46,45,49,1
12.10.2025,2025,sır,164,Joker,OKK Novi Pazar,111,78,33,22,21,25,28,12,29,19,55,46,40,48,1
12.10.2025,2025,sır,157,Vrsac,KK Mladost SP,89,67,14,13,28,20,29,17,18,17,27,48,46,35,1
12.10.2025,2025,sır,162,Mladost Zemun,Sloboda,70,74,15,21,22,13,17,17,16,23,36,35,34,39,-1
13.10.2025,2025,kore,162,Wonju DB,Suwon KT,77,67,26,16,15,21,19,11,17,19,42,36,30,36,-1
12.10.2025,2025,kore,161,KoGas,Suwon KT,68,75,18,23,25,19,17,14,8,19,41,44,31,27,-1
12.10.2025,2025,kore,170,Mobis Phoebus,Wonju DB,75,81,14,19,17,27,28,19,16,16,33,44,47,32,-1
13.10.2025,2025,swit,156,Geneva Lions,BBC Monthey,93,58,25,13,13,6,25,21,30,18,38,19,46,48,1
13.10.2025,2025,swit,153,Sdent BBC Nyon,Neuchatel,68,80,19,10,14,23,12,25,23,22,29,37,37,45,1
13.10.2025,2025,tur,161,Mersin BŞB,Petkim Spor,67,57,14,16,23,12,16,14,14,15,30,35,30,29,-1
13.10.2025,2025,tur,169,Galatasaray,Tofas,76,80,22,24,23,19,14,20,17,17,46,42,34,34,-1
12.10.2025,2025,tur,171,Bursaspor,Anadolu Efes,78,99,8,29,27,29,23,21,20,20,37,56,44,40,-1
11.10.2025,2025,tur,163,Yalovaspor,Fenerbahce,90,97,26,25,18,9,21,23,18,26,51,27,44,44,1
11.10.2025,2025,tur,166,Buyukcekmece,Turk Telekom,99,88,11,22,16,17,26,12,15,17,33,33,38,32,-1
11.10.2025,2025,tur,159,Besiktas,Bahcesehir Kol.,82,78,24,24,16,18,26,24,16,12,48,34,50,28,-1
11.10.2025,2025,tur,175,Karsiyaka,Merkezefendi,105,88,29,21,31,22,26,15,19,30,50,53,41,49,1
13.10.2025,2025,tur b,156,Cayirova,CO Basket,81,64,22,13,14,17,32,24,13,10,35,31,56,23,1
13.10.2025,2025,tur b,154,Bordo Sportif,Trabzonspor,97,79,29,27,26,16,22,16,20,20,56,42,38,40,1
13.10.2025,2025,tur b,160,Final Spor,MKE Ankaragucu,77,83,21,18,19,24,19,19,18,22,39,43,38,40,-1
13.10.2025,2025,tur b,158,Konya BBSK,Harem Spor,73,67,20,18,30,20,13,13,10,16,38,50,26,26,-1
13.10.2025,2025,tur b,157,Istanbul Anka Spor,Fenerbahce 2,74,92,14,30,17,16,29,20,14,26,44,33,49,40,1
12.10.2025,2025,tur b,155,Esenler Erokspor,Balikesir,94,83,18,23,30,26,24,15,22,19,41,56,39,41,1
12.10.2025,2025,tur b,148,Ankara Kolejliler,Çağdaş Bodrum Spor,81,76,26,11,19,23,13,21,23,21,37,42,34,44,1
12.10.2025,2025,tur b,154,iLab Basketbol,Kapakli Spor,84,73,19,16,19,21,22,18,24,18,35,40,40,42,1
13.10.2025,2025,aus,158,Traiskirchen Lions,Vienna Basket,80,74,20,21,17,17,20,24,23,12,41,34,44,35,-1
13.10.2025,2025,aus,164,Swans Gmunden,Graz UBSC,86,79,28,23,21,14,9,20,28,22,51,35,29,50,-1
12.10.2025,2025,aus,156,Kapfenberg Bulls,St. Polten,104,85,31,20,20,20,25,20,28,25,51,40,45,53,1
12.10.2025,2025,aus,154,BBC Nord,Wels,70,96,16,27,14,18,18,24,22,27,43,32,42,49,1
12.10.2025,2025,aus,154,Klosterneuburg Dukes,Oberwart Gunners,97,74,19,19,25,22,33,26,20,7,38,47,59,27,1
08.10.2025,2025,aus,163,Vienna Basket,Graz UBSC,92,72,26,20,25,10,22,24,19,18,46,35,46,37,1
13.10.2025,2025,bul,164,Cherno More,Balkan,75,80,18,20,13,20,19,24,25,16,38,33,43,41,1
12.10.2025,2025,bul,162,Levski,Shumen,96,91,20,21,28,19,20,18,28,33,41,47,38,61,1
12.10.2025,2025,bul,159,Minyor,Rilski Sportist,75,87,14,26,26,17,18,21,17,23,40,43,39,40,-1
13.10.2025,2025,bos,,Slavija,Jahorina,88,84,29,26,23,22,19,20,17,16,55,45,39,33,
13.10.2025,2025,bos,,Posusje,Mrkonjic Grad,70,99,21,17,12,30,21,22,16,30,38,42,43,46,
12.10.2025,2025,bos,,Sloboda,Spars Ilidza,94,72,21,16,23,14,26,28,24,14,37,37,54,38,
12.10.2025,2025,bos,,Orlovik,Leotar Trebinje,78,74,22,14,21,23,14,19,21,18,36,44,33,39,
12.10.2025,2025,bos,,HKK Mostar,Radnicki Gorazde,58,98,13,23,15,21,17,24,13,30,36,36,41,43,
12.10.2025,2025,bos,,KK Bosna,Promo,85,68,21,14,19,20,17,21,28,13,35,39,38,41,
11.10.2025,2025,bos,,Siroki Brijeg,Borac Banja Luka,81,68,21,23,14,16,26,16,20,13,44,30,42,33,
13.10.2025,2025,fra,163,Dijon,Paris,83,97,23,22,21,25,17,27,22,23,45,46,44,45,1
13.10.2025,2025,fra,154,Gravelines-Dunkerque,Strasbourg,78,72,23,21,15,15,19,22,21,14,44,30,41,35,-1
13.10.2025,2025,fra,160,Lyon-Villeurbanne,Le Portel,88,67,24,18,22,22,29,12,13,15,42,44,41,28,-1
12.10.2025,2025,fra,162,JL Bourg,Limoges,74,70,10,23,26,16,19,16,19,15,33,42,35,34,-1
12.10.2025,2025,fra,163,Le Mans,Nanterre,94,87,18,28,21,9,28,18,27,32,46,30,46,59,1
12.10.2025,2025,fra,150,Monaco,La Rochelle,82,62,20,11,22,14,15,23,25,14,31,36,38,39,1
12.10.2025,2025,fra,166,Nancy,Chalon/Saone,96,84,29,14,19,25,30,21,18,24,43,44,51,42,1
11.10.2025,2025,fra,153,Cholet,Saint Quentin,82,59,16,15,28,17,25,20,13,7,31,45,45,20,-1
13.10.2025,2025,ita,168,Trapani,Scafati,101,87,25,30,29,24,22,12,25,21,55,53,34,46,-1
13.10.2025,2025,ita,156,Cremona,Pistoia,65,66,14,12,11,21,20,16,20,17,26,32,36,37,-1
13.10.2025,2025,ita,162,Olimpia Milano,Brescia,88,85,27,24,20,21,25,18,16,22,51,41,43,38,-1
13.10.2025,2025,ita,181,Trento,Varese,106,100,25,27,25,31,29,14,27,28,52,56,43,55,1
13.10.2025,2025,ita,169,Sassari,Basket Napoli,94,76,28,16,22,22,27,7,17,31,44,44,34,48,-1
12.10.2025,2025,ita,163,Reggiana,Treviso,88,64,17,12,16,26,24,12,31,14,29,42,36,45,-1
12.10.2025,2025,ita,163,Venezia,Virtus Bologna,68,76,14,22,17,21,23,17,14,16,36,38,40,30,-1
12.10.2025,2025,ita,164,Tortona,Trieste,82,85,22,23,15,20,23,22,22,20,45,35,45,42,1
13.10.2025,2025,aba,163,Borac,Dubai,74,87,23,24,13,23,27,24,11,16,47,36,51,27,-1
13.10.2025,2025,aba,167,Mega Basket,Mornar Bar,84,59,23,14,21,13,19,21,21,11,37,34,40,32,-1
12.10.2025,2025,aba,150,Zadar,Buducnost,55,91,20,29,9,23,10,19,16,20,49,32,29,36,-1
12.10.2025,2025,aba,159,Crvena zvezda,Igokea,91,68,22,19,27,15,26,13,16,21,41,42,39,37,-1
12.10.2025,2025,aba,164,Cedevita Olimpija,Split,76,74,13,17,18,17,22,18,23,22,30,35,40,45,1
12.10.2025,2025,aba,163,Studentski Centar,Partizan,60,80,17,23,18,23,15,12,10,22,40,41,27,32,-1
09.10.2025,2025,aba,157,Cibona,KK Krka Novo mesto,74,81,24,20,17,20,23,19,10,22,44,37,42,32,-1
13.10.2025,2025,avst,180,Cairns Taipans,x,99,73,28,18,25,21,23,18,23,16,46,46,41,39,-1
12.10.2025,2025,avst,183,Brisbane Bullets,x,85,87,23,18,26,27,17,23,19,19,41,53,40,38,-1
12.10.2025,2025,avst,175,Tasmania JackJumpers,x,109,76,32,17,25,22,27,13,25,24,49,47,40,49,1
11.10.2025,2025,avst,188,Sydney,x,89,79,26,22,23,15,19,25,21,17,48,38,44,38,-1
10.10.2025,2025,avst,183,Perth,x,87,90,23,29,18,19,26,27,20,15,52,37,53,35,-1
13.10.2025,2025,bul,164,Balkan,x,75,80,18,20,13,20,19,24,25,16,38,33,43,41,1
12.10.2025,2025,bul,163,Shumen,x,96,91,20,21,28,19,20,18,28,33,41,47,38,61,1
12.10.2025,2025,bul,160,Rilski Sportist,x,75,87,14,26,26,17,18,21,17,23,40,43,39,40,-1
13.10.2025,2025,cin,200,Jiangsu Dragons,x,112,98,28,29,29,28,27,23,28,18,57,57,50,46,-1
13.10.2025,2025,cin,207,Shanghai,x,110,107,26,29,25,30,26,25,24,17,55,55,51,41,-1
13.10.2025,2025,cin,216,Beijing Royal Fighters,x,99,100,24,29,32,21,26,21,17,29,53,53,47,46,-1
13.10.2025,2025,cin,217,Shenzhen,x,104,91,31,21,20,26,27,22,26,22,52,46,49,48,-1
13.10.2025,2025,cin,212,Sichuan,x,126,114,28,23,27,38,35,27,36,26,51,65,62,62,1
13.10.2025,2025,cin,205,Zhejiang Guangsha,x,102,113,22,27,23,35,24,29,33,22,49,58,53,55,1
13.10.2025,2025,cin,226,Guangdong,x,110,99,23,29,39,22,23,27,25,21,52,61,50,46,-1
12.10.2025,2025,cin,207,Zhejiang Chouzhou,x,123,112,31,33,21,28,42,21,29,30,64,49,63,59,1
13.10.2025,2025,kıbrıs,155,ETHA Engomi,x,107,96,30,23,32,20,25,24,20,29,53,52,49,49,1
12.10.2025,2025,kıbrıs,155,Paralimni,x,89,71,21,25,23,20,26,12,19,14,46,43,38,33,-1
11.10.2025,2025,kıbrıs,156,Apollon,x,105,79,31,23,21,21,23,22,30,13,54,42,45,43,1
13.10.2025,2025,cek,161,USK Prague,x,87,57,29,8,22,10,19,21,17,18,37,32,40,35,-1
12.10.2025,2025,cek,173,Srsni Pisek,x,103,107,25,17,26,23,18,21,27,35,42,49,39,62,1
12.10.2025,2025,cek,164,Decin,x,89,92,19,17,25,22,26,19,19,34,36,47,45,53,1
12.10.2025,2025,cek,160,Jindrichuv Hradec,x,91,67,23,17,21,14,22,15,25,21,40,35,37,46,1
12.10.2025,2025,cek,169,NH Ostrava,x,83,90,19,23,20,26,13,23,31,18,42,46,36,49,1
12.10.2025,2025,cek,163,Brno,x,102,82,18,26,25,10,33,22,26,24,44,35,55,50,1
13.10.2025,2025,bnxt,159,Spirou Charleroi,x,77,87,22,24,20,20,13,23,22,20,46,40,36,42,-1
12.10.2025,2025,bnxt,158,Den Bosch,x,78,84,16,29,23,15,26,23,13,17,45,38,49,30,-1
12.10.2025,2025,bnxt,155,LWD Basket,x,85,48,23,11,20,11,18,9,24,17,34,31,27,41,-1
12.10.2025,2025,bnxt,153,Okapi Aalst,x,79,67,30,17,17,10,18,23,14,17,47,27,41,31,-1
12.10.2025,2025,bnxt,148,Circus Brussels,x,73,93,14,18,12,32,24,22,23,21,32,44,46,44,1
12.10.2025,2025,bnxt,158,BAL Weert,x,72,62,22,11,12,22,21,18,17,11,33,34,39,28,-1
11.10.2025,2025,bnxt,163,Mechelen,x,108,85,22,21,29,24,31,17,26,23,43,53,48,49,1
13.10.2025,2025,lat-st,149,Rapla,x,80,85,21,26,25,22,20,14,14,23,47,47,34,37,-1
12.10.2025,2025,lat-st,171,Keila Coolbet,x,87,80,27,17,18,21,15,23,27,19,44,39,38,46,-1
12.10.2025,2025,lat-st,171,BK Ogre,x,83,96,21,18,17,35,19,16,26,27,39,52,35,53,1
12.10.2025,2025,lat-st,160,BK Liepaja,x,100,97,28,27,25,17,23,31,24,22,55,42,54,46,1
12.10.2025,2025,lat-st,151,Tartu Ulikool,x,74,71,20,24,19,13,15,13,20,21,44,32,28,41,-1
12.10.2025,2025,lat-st,152,Latvijas Universitate,x,77,53,22,8,16,10,28,10,11,25,30,26,38,36,-1
11.10.2025,2025,lat-st,154,BK Liepaja,x,90,74,20,20,24,11,24,28,22,15,40,35,52,37,1
11.10.2025,2025,lat-st,150,Rapla,x,80,65,14,13,23,18,17,19,26,15,27,41,36,41,1
13.10.2025,2025,ger b,161,Munster,x,87,83,18,24,19,27,21,18,29,14,42,46,39,43,1
12.10.2025,2025,ger b,176,Vechta 2,x,99,62,24,25,24,5,30,22,21,10,49,29,52,31,-1
12.10.2025,2025,ger b,153,Kirchheim,x,80,87,22,16,17,20,20,22,21,29,38,37,42,50,1
12.10.2025,2025,ger b,159,Dusseldorf,x,92,84,22,28,19,23,19,16,32,17,50,42,35,49,1
12.10.2025,2025,ger b,156,Nurnberger,x,68,55,17,17,19,9,21,14,11,15,34,28,35,26,-1
12.10.2025,2025,ger b,176,Bayreuth,x,98,74,18,14,34,18,22,21,24,21,32,52,43,45,-1
12.10.2025,2025,ger b,164,PS Karlsruhe,x,100,69,30,16,20,18,23,18,27,17,46,38,41,44,1
12.10.2025,2025,ger b,171,Dresden,x,98,72,20,19,34,15,18,18,26,20,39,49,36,46,-1
13.10.2025,2025,ger,165,Bayern,x,85,91,26,19,20,22,15,29,24,21,45,42,44,45,1
13.10.2025,2025,ger,173,Alba Berlin,x,74,75,26,17,17,11,19,22,12,25,43,28,41,37,-1
13.10.2025,2025,ger,157,Syntainics MBC,x,77,85,22,10,21,29,17,20,17,26,32,50,37,43,1
13.10.2025,2025,ger,169,Chemnitz,x,78,73,19,10,23,25,15,15,21,23,29,48,30,44,-1
12.10.2025,2025,ger,164,Vechta,x,68,89,16,26,20,22,17,21,15,20,42,42,38,35,-1
12.10.2025,2025,ger,166,Ulm,x,103,100,21,31,25,20,25,18,32,31,52,45,43,63,1
12.10.2025,2025,ger,162,Oldenburg,x,85,79,19,16,24,10,21,16,21,37,35,34,37,58,1
11.10.2025,2025,ger,165,Wurzburg,x,86,78,23,18,17,18,17,23,29,19,41,35,40,48,1
13.10.2025,2025,mac,163,Szombathely,x,82,87,26,22,18,22,12,25,26,18,48,40,37,44,-1
12.10.2025,2025,mac,160,Pecsi VSK,x,75,68,21,13,14,14,22,21,18,20,34,28,43,38,1
12.10.2025,2025,mac,173,Alba Fehervar,x,79,70,19,21,19,22,18,9,23,18,40,41,27,41,-1
12.10.2025,2025,mac,158,KTE-Duna,x,94,62,20,14,17,18,23,12,34,18,34,35,35,52,1
12.10.2025,2025,mac,158,Szolnoki Olaj,x,71,75,22,14,15,18,11,18,23,25,36,33,29,48,-1
12.10.2025,2025,mac,160,Budapesti Honved Se,x,104,85,31,19,27,30,23,16,23,20,50,57,39,43,1
12.10.2025,2025,mac,171,Kormend,x,88,76,25,13,24,15,18,28,21,20,38,39,46,41,1
13.10.2025,2025,ita b,149,Forli,x,82,63,20,9,25,19,18,19,19,16,29,44,37,35,-1
13.10.2025,2025,ita b,151,Basket Torino,x,72,68,16,14,20,23,21,17,15,14,30,43,38,29,-1
13.10.2025,2025,ita b,152,Libertas Livorno,x,82,71,20,14,21,17,22,25,19,15,34,38,47,34,1
13.10.2025,2025,ita b,160,Assigeco Piacenza,x,87,81,34,22,22,17,20,24,11,18,56,39,44,29,-1
13.10.2025,2025,ita b,157,Urania Milano,x,84,76,27,24,10,19,17,17,30,16,51,29,34,46,1
13.10.2025,2025,ita b,154,Cividale,x,82,72,23,21,17,18,20,14,22,19,44,35,34,41,-1
12.10.2025,2025,ita b,153,Pesaro,x,86,80,24,20,17,17,21,20,24,23,44,34,41,47,1
12.10.2025,2025,ita b,150,Vigevano,x,85,80,24,18,18,22,20,18,23,22,42,40,38,45,1
12.10.2025,2025,ita b,156,Fortitudo Bologna,x,70,79,14,24,23,20,22,15,11,20,38,43,37,31,-1
11.10.2025,2025,ita b,151,Cento,x,87,69,27,13,14,20,27,17,19,19,40,34,44,38,1
13.10.2025,2025,lat lkl,174,Nevezis,x,95,91,31,18,19,27,19,29,26,17,49,46,48,43,1
13.10.2025,2025,lat lkl,166,Juventus,x,46,91,17,21,17,21,6,26,6,23,38,38,32,29,-1
12.10.2025,2025,lat lkl,172,BC Wolves,x,89,74,25,23,18,19,29,15,17,17,48,37,44,34,-1
12.10.2025,2025,lat lkl,169,Rytas,x,67,84,19,21,13,29,17,20,18,14,40,42,37,32,-1
13.10.2025,2025,mak,,Cair 2030,x,73,93,19,20,19,20,20,26,15,27,39,39,46,42,1
13.10.2025,2025,mak,,Vardar,x,87,75,27,15,17,21,20,18,23,21,42,38,38,44,1
12.10.2025,2025,mak,,Rabotnicki,x,73,81,29,26,10,25,18,14,16,16,55,35,32,32,1
12.10.2025,2025,mak,,MZT Skopje,x,68,67,19,21,20,13,16,20,13,13,40,33,36,26,1
12.10.2025,2025,mak,,TFT Skopje,x,60,61,9,4,22,20,15,17,14,20,13,42,32,34,1
12.10.2025,2025,mak,,Tikvesh,x,93,89,17,19,13,18,21,18,28,24,36,31,39,52,1
13.10.2025,2025,pol,159,Spojnia Stargard,x,83,78,20,24,24,20,18,22,21,12,44,44,40,33,-1
12.10.2025,2025,pol,157,Gornik Walbrzych,x,74,79,16,22,28,19,19,12,11,26,38,47,31,37,-1
12.10.2025,2025,pol,160,Dziki Warszawa,x,79,70,29,19,10,16,20,17,20,18,48,26,37,38,-1
11.10.2025,2025,pol,167,Legia,x,78,89,24,15,19,29,24,24,11,21,39,48,48,32,-1
11.10.2025,2025,pol,159,Czarni Slupsk,x,70,66,27,15,15,21,13,20,15,10,42,36,33,25,-1
13.10.2025,2025,rom,160,CSM Constanta,x,83,82,21,20,22,22,24,20,16,20,41,44,44,36,-1
13.10.2025,2025,rom,168,CSU Sibiu,x,83,92,23,22,21,18,20,27,19,25,45,39,47,44,1
12.10.2025,2025,rom,162,Arges Pitesti,x,81,67,16,6,26,16,18,23,21,22,22,42,41,43,1
12.10.2025,2025,rom,150,Corona Brasov,x,76,78,21,17,17,29,21,9,17,23,38,46,30,40,-1
12.10.2025,2025,rom,157,Rapid Bucuresti,x,68,72,23,23,18,13,13,18,14,18,46,31,31,32,-1
12.10.2025,2025,rom,160,Voluntari,x,93,66,21,16,22,14,30,19,20,17,37,36,49,37,1
12.10.2025,2025,rom,162,CSM Targu Mures,x,76,102,28,19,20,33,16,31,12,19,47,53,47,31,-1
11.10.2025,2025,rom,154,Dinamo Bucharest,x,84,70,13,19,24,18,25,16,22,17,32,42,41,39,1
13.10.2025,2025,vtb,163,Zenit Petersburg,x,83,77,22,14,24,27,21,19,16,17,36,51,40,33,-1
12.10.2025,2025,vtb,155,Saratov,x,84,54,29,9,19,10,21,21,15,14,38,29,42,29,-1
12.10.2025,2025,vtb,168,Samara,x,76,64,22,22,14,18,14,15,26,9,44,32,29,35,-1
12.10.2025,2025,vtb,152,Uralmash Ekaterinburg,x,66,101,11,26,24,29,11,21,20,25,37,53,32,45,1
12.10.2025,2025,vtb,152,MBA Moscow,x,63,76,18,20,15,15,21,20,9,21,38,30,41,30,-1
13.10.2025,2025,sır,157,Dynamic,x,103,66,32,15,25,21,26,15,20,15,47,46,41,35,-1
12.10.2025,2025,sır,154,Cacak 94,x,61,77,16,20,8,16,15,17,22,24,36,24,32,46,1
12.10.2025,2025,sır,166,Zlatibor,x,76,88,14,28,22,24,15,24,25,12,42,46,39,37,-1
12.10.2025,2025,sır,161,Tamis,x,78,79,20,20,13,25,26,14,19,20,40,38,40,39,-1
12.10.2025,2025,sır,166,OKK Beograd,x,89,93,20,22,23,23,19,26,27,22,42,46,45,49,1
12.10.2025,2025,sır,164,OKK Novi Pazar,x,111,78,33,22,21,25,28,12,29,19,55,46,40,48,1
12.10.2025,2025,sır,157,KK Mladost SP,x,89,67,14,13,28,20,29,17,18,17,27,48,46,35,1
12.10.2025,2025,sır,162,Sloboda,x,70,74,15,21,22,13,17,17,16,23,36,35,34,39,-1
13.10.2025,2025,kore,162,Suwon KT,x,77,67,26,16,15,21,19,11,17,19,42,36,30,36,-1
12.10.2025,2025,kore,161,Suwon KT,x,68,75,18,23,25,19,17,14,8,19,41,44,31,27,-1
12.10.2025,2025,kore,170,Wonju DB,x,75,81,14,19,17,27,28,19,16,16,33,44,47,32,-1
13.10.2025,2025,swit,156,BBC Monthey,x,93,58,25,13,13,6,25,21,30,18,38,19,46,48,1
13.10.2025,2025,swit,153,Neuchatel,x,68,80,19,10,14,23,12,25,23,22,29,37,37,45,1
13.10.2025,2025,tur,161,Petkim Spor,x,67,57,14,16,23,12,16,14,14,15,30,35,30,29,-1
13.10.2025,2025,tur,169,Tofas,x,76,80,22,24,23,19,14,20,17,17,46,42,34,34,-1
12.10.2025,2025,tur,171,Anadolu Efes,x,78,99,8,29,27,29,23,21,20,20,37,56,44,40,-1
11.10.2025,2025,tur,163,Fenerbahce,x,90,97,26,25,18,9,21,23,18,26,51,27,44,44,1
11.10.2025,2025,tur,166,Turk Telekom,x,99,88,11,22,16,17,26,12,15,17,33,33,38,32,-1
11.10.2025,2025,tur,159,Bahcesehir Kol.,x,82,78,24,24,16,18,26,24,16,12,48,34,50,28,-1
11.10.2025,2025,tur,175,Merkezefendi,x,105,88,29,21,31,22,26,15,19,30,50,53,41,49,1
13.10.2025,2025,tur b,156,CO Basket,x,81,64,22,13,14,17,32,24,13,10,35,31,56,23,1
13.10.2025,2025,tur b,154,Trabzonspor,x,97,79,29,27,26,16,22,16,20,20,56,42,38,40,1
13.10.2025,2025,tur b,160,MKE Ankaragucu,x,77,83,21,18,19,24,19,19,18,22,39,43,38,40,-1
13.10.2025,2025,tur b,158,Harem Spor,x,73,67,20,18,30,20,13,13,10,16,38,50,26,26,-1
13.10.2025,2025,tur b,157,Fenerbahce 2,x,74,92,14,30,17,16,29,20,14,26,44,33,49,40,1
12.10.2025,2025,tur b,155,Balikesir,x,94,83,18,23,30,26,24,15,22,19,41,56,39,41,1
12.10.2025,2025,tur b,148,Çağdaş Bodrum Spor,x,81,76,26,11,19,23,13,21,23,21,37,42,34,44,1
12.10.2025,2025,tur b,154,Kapakli Spor,x,84,73,19,16,19,21,22,18,24,18,35,40,40,42,1
13.10.2025,2025,aus,158,Vienna Basket,x,80,74,20,21,17,17,20,24,23,12,41,34,44,35,-1
13.10.2025,2025,aus,164,Graz UBSC,x,86,79,28,23,21,14,9,20,28,22,51,35,29,50,-1
12.10.2025,2025,aus,156,St. Polten,x,104,85,31,20,20,20,25,20,28,25,51,40,45,53,1
12.10.2025,2025,aus,154,Wels,x,70,96,16,27,14,18,18,24,22,27,43,32,42,49,1
12.10.2025,2025,aus,154,Oberwart Gunners,x,97,74,19,19,25,22,33,26,20,7,38,47,59,27,1
08.10.2025,2025,aus,163,Graz UBSC,x,92,72,26,20,25,10,22,24,19,18,46,35,46,37,1
13.10.2025,2025,bul,164,Balkan,x,75,80,18,20,13,20,19,24,25,16,38,33,43,41,1
12.10.2025,2025,bul,162,Shumen,x,96,91,20,21,28,19,20,18,28,33,41,47,38,61,1
12.10.2025,2025,bul,159,Rilski Sportist,x,75,87,14,26,26,17,18,21,17,23,40,43,39,40,-1
13.10.2025,2025,bos,,Jahorina,x,88,84,29,26,23,22,19,20,17,16,55,45,39,33,
13.10.2025,2025,bos,,Mrkonjic Grad,x,70,99,21,17,12,30,21,22,16,30,38,42,43,46,
12.10.2025,2025,bos,,Spars Ilidza,x,94,72,21,16,23,14,26,28,24,14,37,37,54,38,
12.10.2025,2025,bos,,Leotar Trebinje,x,78,74,22,14,21,23,14,19,21,18,36,44,33,39,
12.10.2025,2025,bos,,Radnicki Gorazde,x,58,98,13,23,15,21,17,24,13,30,36,36,41,43,
12.10.2025,2025,bos,,Promo,x,85,68,21,14,19,20,17,21,28,13,35,39,38,41,
11.10.2025,2025,bos,,Borac Banja Luka,x,81,68,21,23,14,16,26,16,20,13,44,30,42,33,
13.10.2025,2025,fra,163,Paris,x,83,97,23,22,21,25,17,27,22,23,45,46,44,45,1
13.10.2025,2025,fra,154,Strasbourg,x,78,72,23,21,15,15,19,22,21,14,44,30,41,35,-1
13.10.2025,2025,fra,160,Le Portel,x,88,67,24,18,22,22,29,12,13,15,42,44,41,28,-1
12.10.2025,2025,fra,162,Limoges,x,74,70,10,23,26,16,19,16,19,15,33,42,35,34,-1
12.10.2025,2025,fra,163,Nanterre,x,94,87,18,28,21,9,28,18,27,32,46,30,46,59,1
12.10.2025,2025,fra,150,La Rochelle,x,82,62,20,11,22,14,15,23,25,14,31,36,38,39,1
12.10.2025,2025,fra,166,Chalon/Saone,x,96,84,29,14,19,25,30,21,18,24,43,44,51,42,1
11.10.2025,2025,fra,153,Saint Quentin,x,82,59,16,15,28,17,25,20,13,7,31,45,45,20,-1
13.10.2025,2025,ita,168,Scafati,x,101,87,25,30,29,24,22,12,25,21,55,53,34,46,-1
13.10.2025,2025,ita,156,Pistoia,x,65,66,14,12,11,21,20,16,20,17,26,32,36,37,-1
13.10.2025,2025,ita,162,Brescia,x,88,85,27,24,20,21,25,18,16,22,51,41,43,38,-1
13.10.2025,2025,ita,181,Varese,x,106,100,25,27,25,31,29,14,27,28,52,56,43,55,1
13.10.2025,2025,ita,169,Basket Napoli,x,94,76,28,16,22,22,27,7,17,31,44,44,34,48,-1
12.10.2025,2025,ita,163,Treviso,x,88,64,17,12,16,26,24,12,31,14,29,42,36,45,-1
12.10.2025,2025,ita,163,Virtus Bologna,x,68,76,14,22,17,21,23,17,14,16,36,38,40,30,-1
12.10.2025,2025,ita,164,Trieste,x,82,85,22,23,15,20,23,22,22,20,45,35,45,42,1
13.10.2025,2025,aba,163,Dubai,x,74,87,23,24,13,23,27,24,11,16,47,36,51,27,-1
13.10.2025,2025,aba,167,Mornar Bar,x,84,59,23,14,21,13,19,21,21,11,37,34,40,32,-1
12.10.2025,2025,aba,150,Buducnost,x,55,91,20,29,9,23,10,19,16,20,49,32,29,36,-1
12.10.2025,2025,aba,159,Igokea,x,91,68,22,19,27,15,26,13,16,21,41,42,39,37,-1
12.10.2025,2025,aba,164,Split,x,76,74,13,17,18,17,22,18,23,22,30,35,40,45,1
12.10.2025,2025,aba,163,Partizan,x,60,80,17,23,18,23,15,12,10,22,40,41,27,32,-1
09.10.2025,2025,aba,157,KK Krka Novo mesto,x,74,81,24,20,17,20,23,19,10,22,44,37,42,32,-1
11.10.2025,2025,rus,146,CSKA Moscow 2,Temp Sumz Revda,71,73,16,21,19,15,23,25,13,12,37,34,48,25,-1
11.10.2025,2025,rus,147,Dynamo Grozny,Novosibirsk,59,78,12,20,15,11,15,26,17,21,32,26,41,38,1
11.10.2025,2025,rus,147,Khimki M.,Lokomotiv Kuban 2,85,71,20,16,19,25,25,7,21,23,36,44,32,44,1
11.10.2025,2025,rus,150,Tambov,Dome-Springs Izhevsk,62,76,15,22,23,21,9,16,15,17,37,44,25,32,-1
11.10.2025,2025,rus,151,University-Ugra,Bars Rostov,75,64,12,19,22,15,22,15,19,15,31,37,37,34,-1
11.10.2025,2025,rus,151,Zenit Petersburg 2,Barnaul,80,69,30,23,12,16,18,13,20,17,53,28,31,37,-1
16.10.2025,2025,eurocup,165,Joventut Badalona,BC Wolves,63,86,17,25,18,11,15,28,13,22,42,29,43,35,-1
16.10.2025,2025,eurocup,153,Aris,Hapoel Jerusalem,68,78,17,23,22,9,12,16,17,30,40,31,28,47,-1
16.10.2025,2025,eurocup,158,Buducnost,Trefl Sopot,92,83,29,20,19,10,15,22,29,31,49,29,37,60,1
16.10.2025,2025,eurocup,157,Bahcesehir Kol.,Trento,110,70,26,25,37,14,20,16,27,15,51,51,36,42,-1
15.10.2025,2025,eurocup,174,Hamburg,Cluj-Napoca,67,103,16,19,11,28,21,34,19,22,35,39,55,41,1
15.10.2025,2025,eurocup,154,JL Bourg,Turk Telekom,67,63,15,11,23,22,9,16,20,14,26,45,25,34,-1
15.10.2025,2025,eurocup,166,Hapoel Tel-Aviv,Gran Canaria,79,66,16,14,21,15,24,19,18,18,30,36,43,36,-1
15.10.2025,2025,eurocup,162,Cedevita Olimpija,Lietkabelis,76,72,18,10,25,13,17,27,16,22,28,38,44,38,1
14.10.2025,2025,eurocup,167,Besiktas,Ulm,107,74,31,9,30,19,28,21,18,25,40,49,49,43,1
16.10.2025,2025,champions,161,Chemnitz,Benfica,103,75,32,17,25,16,22,21,24,21,49,41,43,45,1
16.10.2025,2025,champions,155,Kolossos Rhodes,Tenerife,47,71,13,15,8,25,20,19,6,12,28,33,39,18,-1
16.10.2025,2025,champions,166,Rytas,Slask Wroclaw,98,75,28,16,22,17,20,24,28,18,44,39,44,46,1
16.10.2025,2025,champions,157,Szombathely,Reggiana,78,71,17,13,17,19,23,22,21,17,30,36,45,38,1
15.10.2025,2025,champions,163,Tortona,Manresa,102,85,30,16,25,22,25,21,22,26,46,47,46,48,1
15.10.2025,2025,champions,164,Bonn,AEK Athens,93,74,26,17,13,19,20,23,34,15,43,32,43,49,1
15.10.2025,2025,champions,160,Karsiyaka,Saint Quentin,84,74,28,17,19,20,21,25,16,12,45,39,46,28,-1
15.10.2025,2025,champions,159,Maccabi Ironi Ramat Gan,VEF Riga,78,71,20,13,18,17,13,25,27,16,33,35,38,43,1
16.10.2025,2025,fiba,159,BC Dnipro,Sporting CP,57,68,15,21,16,11,16,17,10,19,36,27,33,29,-1
16.10.2025,2025,fiba,161,Caledonia Gladiators,Dijon,54,90,14,19,19,26,14,23,7,22,33,45,37,29,-1
16.10.2025,2025,fiba,159,Sassari,Anwil Wloclawek,69,66,22,22,16,17,21,13,10,14,44,33,34,24,-1
16.10.2025,2025,fiba,165,Bursaspor,Anorthosis,86,79,20,19,21,19,22,17,23,24,39,40,39,47,1
16.10.2025,2025,fiba,156,PAOK,FC Porto,89,70,26,18,20,21,22,24,21,7,44,41,46,28,-1
16.10.2025,2025,fiba,161,Balkan,BC Prievidza,70,89,11,26,17,23,18,23,24,17,37,40,41,41,1
16.10.2025,2025,fiba,161,Fribourg Olympic,CSM Constanta,103,76,20,24,32,24,22,14,29,14,44,56,36,43,-1
16.10.2025,2025,fiba,160,Norrkoping,Spirou Charleroi,85,97,22,23,19,28,17,19,27,27,45,47,36,54,1
16.10.2025,2025,fiba,154,Spojnia Stargard,Arges Pitesti,65,62,19,15,13,10,19,19,14,18,34,23,38,32,-1
16.10.2025,2025,fiba,161,Trepca,Ludwigsburg,57,70,21,21,11,14,13,12,12,23,42,25,25,35,-1
16.10.2025,2025,fiba,162,Keravnos,Basketball Braunschweig,95,94,22,28,19,20,21,25,18,7,50,39,46,25,-1
16.10.2025,2025,fiba,164,AEK Larnaca,Tofas,69,96,20,27,16,25,20,23,13,21,47,41,43,34,-1
16.10.2025,2025,fiba,164,Kutaisi,Bilbao,57,88,15,19,11,28,16,23,15,18,34,39,39,33,-1
16.10.2025,2025,fiba,149,Parnu,CSM Oradea,72,84,13,23,23,16,16,21,20,24,36,39,37,44,1
16.10.2025,2025,fiba,150,Szolnoki Olaj,Limburg,95,100,17,22,30,19,17,25,22,20,39,49,42,42,1
16.10.2025,2025,fiba,158,Rilski Sportist,BC Kalev/Cramo,61,87,9,17,16,17,20,29,16,24,26,33,49,40,1
16.10.2025,2025,fiba,165,Sabah Baku,Maroussi,70,82,27,25,13,16,13,21,17,20,52,29,34,37,-1
15.10.2025,2025,fiba,159,Antwerp Giants,Cholet,81,94,17,23,28,26,19,20,17,25,40,54,39,42,1
15.10.2025,2025,fiba,168,Le Portel,Alba Fehervar,104,73,23,24,25,20,27,18,29,11,47,45,45,40,1
15.10.2025,2025,fiba,168,Levice,Basket Zaragoza,96,80,24,21,25,10,25,15,22,34,45,35,40,56,1
16.10.2025,2025,aba 2,156,Joker,Siroki Brijeg,110,95,27,16,33,20,28,29,22,30,43,53,57,52,1
15.10.2025,2025,aba 2,152,Zlatibor,Borac Banja Luka,90,93,23,26,14,25,24,19,20,11,49,39,43,31,-1
15.10.2025,2025,aba 2,156,Podgorica,Pelister,90,79,21,22,20,21,22,26,27,10,43,41,48,37,1
16.10.2025,2025,lat-st,168,BK Ogre,Tal Tech,86,66,17,16,24,8,26,18,19,24,33,32,44,43,1
15.10.2025,2025,lat-st,165,Rapla,Keila KK,100,73,26,24,26,15,29,15,19,19,50,41,44,38,-1
15.10.2025,2025,lat-st,150,Valmiera Glass Via,Tartu Ulikool,89,87,22,17,20,12,20,19,14,28,39,32,39,42,1
16.10.2025,2025,fin,167,UU-Korihait Uusikaupunki,Helsinki Seagulls,58,97,17,19,17,25,7,20,17,33,36,42,27,50,-1
12.10.2025,2025,fin,163,BC Nokia,UU-Korihait Uusikaupunki,81,98,26,34,15,23,22,21,18,20,60,38,43,38,-1
11.10.2025,2025,fin,161,Bisons Loimaa,Pyrinto Tampere,77,69,17,16,17,14,25,19,18,20,33,31,44,38,1
11.10.2025,2025,fin,165,Helsinki Seagulls,Kataja,105,78,29,14,22,25,26,20,28,19,43,47,46,47,1
11.10.2025,2025,fin,159,Kobrat,Karhu Basket,97,88,23,21,22,20,22,25,30,22,44,42,47,52,1
11.10.2025,2025,fin,167,KTP Kotka Basket,Kouvot Kouvola,101,107,17,25,26,25,23,23,25,18,42,51,46,43,1
11.10.2025,2025,fin,172,Honka,Salon Vilpas,82,96,14,21,24,23,24,22,20,30,35,47,46,50,1
16.10.2025,2025,ita b,156,Forli,Pesaro,71,50,18,9,20,15,11,14,22,12,27,35,25,34,-1
16.10.2025,2025,ita b,155,Urania Milano,Sebastiani Rieti,66,71,22,18,14,17,16,21,14,15,40,31,37,29,-1
16.10.2025,2025,ita b,155,Vigevano,Nardo,84,68,30,15,14,15,28,19,12,19,45,29,47,31,1
16.10.2025,2025,ita b,154,Libertas Livorno,JuVi Cremona,79,62,25,15,14,11,19,17,21,19,40,25,36,40,-1
16.10.2025,2025,ita b,155,Assigeco Piacenza,Avellino Basket,83,92,23,22,24,24,10,23,26,23,45,48,33,49,1
16.10.2025,2025,ita b,151,Basket Torino,Brindisi,82,61,18,11,19,14,26,17,19,19,29,33,43,38,1
16.10.2025,2025,ita b,150,Cividale,Udine,75,73,19,23,18,19,22,19,16,12,42,37,41,28,-1
16.10.2025,2025,ita b,161,Fortitudo Bologna,Cento,87,67,15,10,25,16,28,19,19,22,25,41,47,41,1
16.10.2025,2025,ita b,159,Orzinuovi,Rimini,81,98,26,36,20,22,15,17,20,23,62,42,32,43,-1
16.10.2025,2025,ita b,152,Verona,Cantu,77,80,29,17,20,21,20,29,8,13,46,41,49,21,-1
16.10.2025,2025,lat-st,171,Siauliai,Juventus,87,83,24,17,21,20,17,28,25,18,41,41,45,43,1
15.10.2025,2025,lat-st,165,Nevezis,Mazeikiai,89,71,26,26,19,21,28,8,16,16,52,40,36,32,-1
15.10.2025,2025,lat-st,177,Jonava,Neptunas,88,84,25,27,19,24,28,11,16,22,52,43,39,38,-1
16.10.2025,2025,vtb,170,Lokomotiv Kuban,Uralmash Ekaterinburg,91,80,21,26,26,20,18,20,26,14,47,46,38,40,-1
16.10.2025,2025,vtb,145,Enisey,Parma Perm,89,61,19,15,27,14,23,22,20,10,34,41,45,30,1
15.10.2025,2025,vtb,156,Unics Kazan,Astana,97,81,15,15,25,24,25,27,32,15,30,49,52,47,1
15.10.2025,2025,vtb,152,Samara,Nizhny Novgorod,87,89,21,16,25,23,21,27,20,23,37,48,48,43,1
15.10.2025,2025,vtb,154,Saratov,MBA Moscow,68,76,16,25,15,17,18,14,19,20,41,32,32,39,-1
16.10.2025,2025,rus,146,Dome-Springs Izhevsk,Dynamo Grozny,80,76,18,17,13,21,20,23,29,15,35,34,43,44,1
16.10.2025,2025,rus,150,Temp Sumz Revda,Zenit Petersburg 2,77,88,11,15,26,16,19,22,21,35,26,42,41,56,1
16.10.2025,2025,rus,145,Novosibirsk,Khimki M.,66,77,23,15,19,12,8,21,14,16,38,31,29,30,-1
16.10.2025,2025,rus,149,Barnaul,University-Ugra,75,62,20,17,21,9,16,13,18,23,37,30,29,41,-1
15.10.2025,2025,rus,140,Chelyabinsk,Tambov,78,57,13,17,23,14,18,14,24,12,30,37,32,36,-1
15.10.2025,2025,rus,145,Metallurg,CSKA Moscow 2,65,76,22,24,20,20,6,23,17,9,46,40,29,26,-1
15.10.2025,2025,rus,145,Irkutsk,Bars Rostov,65,80,23,20,21,16,7,19,14,25,43,37,26,39,-1
15.10.2025,2025,rus,154,Dynamo Vladivostok,Lokomotiv Kuban 2,80,75,14,16,22,13,17,21,27,25,30,35,38,52,1
16.10.2025,2025,sloven,152,KK Krka Novo mesto,Helios Domzale,86,66,18,24,23,19,15,11,30,12,42,42,26,42,-1
14.10.2025,2025,sloven,157,LTH Castings,Rogaska,79,60,23,19,9,9,25,21,22,11,42,18,46,33,1
12.10.2025,2025,sloven,157,KK Krka Novo mesto,Tajfun Sentjur,95,61,23,14,18,18,24,13,30,16,37,36,37,46,1
12.10.2025,2025,sloven,158,Zlatorog Lasko,Sencur,69,83,14,18,18,24,19,22,18,19,32,42,41,37,-1
12.10.2025,2025,sloven,149,Helios Domzale,KK Triglav Kranj,73,48,24,14,24,9,14,15,11,10,38,33,29,21,-1
11.10.2025,2025,sloven,160,Ilirija,Podcetrtek,75,79,21,21,11,25,19,14,24,19,42,36,33,43,-1
16.10.2025,2025,swit,162,Regio Basel,SAM Massagno,63,73,12,23,27,18,12,12,12,20,35,45,24,32,-1
14.10.2025,2025,cro,155,Zadar,Dubrava,101,72,25,14,26,16,26,22,24,20,39,42,48,44,1
14.10.2025,2025,cro,162,Cedevita Junior,Split,83,95,25,22,24,31,10,23,24,19,47,55,33,43,-1
14.10.2025,2025,cro,156,Dubrovnik,Kvarner,76,81,14,19,23,15,17,14,13,19,33,38,31,32,-1
12.10.2025,2025,cro,163,Dinamo Zagreb,Osijek,79,65,15,15,18,16,19,18,27,16,30,34,37,43,-1
12.10.2025,2025,cro,155,Alkar,Zabok,82,76,22,16,16,21,21,32,23,7,38,37,53,30,1
12.10.2025,2025,cro,162,GKK Sibenka,Cibona,78,91,29,20,15,13,15,31,19,27,49,28,46,46,1
12.10.2025,2025,lat nkl,163,Jurbarkas,Silute,81,77,26,27,19,10,23,14,13,26,53,29,37,39,-1
12.10.2025,2025,lat nkl,157,Delikatesas Joniskis,BC Olimpas Palanga,57,70,22,13,7,21,21,17,7,19,35,28,38,26,-1
12.10.2025,2025,lat nkl,155,Neptunas 2,Ukmerges Stekas,85,67,23,16,20,14,24,18,18,19,39,34,42,37,1
12.10.2025,2025,lat nkl,161,Plunges Olimpas,Kretinga,74,98,10,17,18,30,21,26,25,25,27,48,47,50,1
12.10.2025,2025,lat nkl,160,Rytas 2,Suduva-Mantinga,84,96,19,28,24,27,27,23,14,18,47,51,50,32,1
12.10.2025,2025,lat nkl,164,Vytis VDU,Telsiai,108,100,21,17,21,21,16,25,31,26,38,42,41,57,1
12.10.2025,2025,lat nkl,150,Zalgiris Kaunas 2,Alytaus Alytus,78,68,26,17,15,13,27,17,10,21,43,28,44,31,-1
12.10.2025,2025,lat nkl,163,Vilkaviskis,Omega-Tauras,86,64,24,13,25,18,20,15,17,18,37,43,35,35,-1
12.10.2025,2025,fra b,153,Ada Blois,Caen,117,80,25,19,25,15,37,26,30,20,44,40,63,50,1
12.10.2025,2025,fra b,150,Boulazac,Orleans,85,78,19,22,17,19,19,20,30,17,41,36,39,47,1
11.10.2025,2025,fra b,161,Antibes,Roanne,87,79,24,15,14,33,20,16,29,15,39,47,36,44,-1
11.10.2025,2025,fra b,153,Hyeres-Toulon,Denain-Voltaire,89,85,26,19,17,22,15,14,31,30,45,39,29,61,1
11.10.2025,2025,fra b,167,St. Chamond,Chalons-Reims,99,80,28,22,12,23,35,10,24,25,50,35,45,49,1
11.10.2025,2025,fra b,161,Vichy,Chartres,97,87,29,26,25,18,22,23,21,20,55,43,45,41,1
11.10.2025,2025,fra b,166,Aix Maurienne,Evreux,101,73,29,22,21,21,25,12,26,18,51,42,37,44,-1
11.10.2025,2025,fra b,162,Nantes,ASA,85,97,19,26,22,26,21,20,23,25,45,48,41,48,1
11.10.2025,2025,fra b,158,Poitiers,Fos-sur-Mer,80,64,22,14,23,14,18,20,17,16,36,37,38,33,-1
11.10.2025,2025,fra b,158,Rouen,Pau-Orthez,79,75,21,18,14,15,28,20,16,22,39,29,48,38,1
05.10.2025,2025,fra b,150,Boulazac,Antibes,69,72,16,23,18,18,16,18,19,13,39,36,34,32,-1
05.10.2025,2025,fra b,157,Fos-sur-Mer,Rouen,75,67,19,21,12,11,21,18,23,17,40,23,39,40,1
04.10.2025,2025,fra b,164,ASA,Poitiers,83,80,24,27,25,22,19,16,15,15,51,47,35,30,-1
04.10.2025,2025,fra b,163,Hyeres-Toulon,St. Chamond,79,99,18,25,20,30,21,28,20,16,43,50,49,36,1
04.10.2025,2025,fra b,156,Ada Blois,Nantes,108,75,23,20,22,19,29,22,34,14,43,41,51,48,1
04.10.2025,2025,fra b,161,Caen,Aix Maurienne,77,72,13,19,26,21,24,15,14,17,32,47,39,31,-1
04.10.2025,2025,fra b,157,Chalons-Reims,Vichy,81,73,22,26,20,14,23,8,16,25,48,34,31,41,-1
04.10.2025,2025,fra b,158,Chartres,Orleans,88,97,22,24,20,22,28,28,18,23,46,42,56,41,1
04.10.2025,2025,fra b,162,Evreux,Roanne,81,83,24,19,24,23,15,16,18,25,43,47,31,43,-1
04.10.2025,2025,fra b,158,Pau-Orthez,Denain-Voltaire,72,81,11,19,26,19,15,20,20,23,30,45,35,43,-1
01.10.2025,2025,fra b,160,Antibes,Rouen,92,84,18,27,33,19,22,18,19,20,45,52,40,39,-1
01.10.2025,2025,fra b,155,ASA,Vichy,87,80,15,18,20,19,31,24,21,19,33,39,55,40,1
01.10.2025,2025,fra b,167,St. Chamond,Chartres,99,75,36,14,22,20,22,24,19,17,50,42,46,36,-1
01.10.2025,2025,fra b,164,Aix Maurienne,Fos-sur-Mer,86,66,20,19,22,6,16,21,28,20,39,28,37,48,1
01.10.2025,2025,fra b,153,Caen,Hyeres-Toulon,68,62,12,14,23,9,13,27,20,12,26,32,40,32,-1
01.10.2025,2025,fra b,150,Denain-Voltaire,Boulazac,63,80,12,17,14,19,10,25,27,19,29,33,35,46,1
01.10.2025,2025,fra b,155,Nantes,Pau-Orthez,84,89,20,18,29,21,15,28,20,22,38,50,43,42,1
01.10.2025,2025,fra b,159,Poitiers,Chalons-Reims,74,84,19,14,20,20,19,23,16,27,33,40,42,43,1
16.10.2025,2025,eurolig,160,Barcelona,Monaco,86,71,26,18,21,21,24,15,15,17,44,42,39,32,-1
15.10.2025,2025,eurolig,166,Partizan,Bayern,86,78,24,15,25,17,22,20,15,26,39,42,42,41,-1
15.10.2025,2025,eurolig,170,Baskonia,Real Madrid,76,72,16,18,20,17,12,17,28,20,34,37,29,48,-1
15.10.2025,2025,eurolig,164,Paris,Panathinaikos,84,80,21,19,24,20,24,20,15,21,40,44,44,36,-1
15.10.2025,2025,eurolig,155,Virtus Bologna,Zalgiris Kaunas,68,71,15,16,15,28,22,16,16,11,31,43,38,27,-1
15.10.2025,2025,eurolig,153,Olympiacos,Olimpia Milano,89,68,23,17,16,10,24,21,26,20,40,26,45,46,1
15.10.2025,2025,eurolig,166,Maccabi Tel Aviv,Anadolu Efes,93,91,23,24,29,28,20,22,21,17,47,57,42,38,-1
15.10.2025,2025,eurolig,160,Fenerbahce,Crvena zvezda,57,76,12,26,19,12,11,16,15,22,38,31,27,37,-1
15.10.2025,2025,eurolig,163,Alba Berlin,Lyon-Villeurbanne,84,79,20,13,16,23,28,18,20,25,33,39,46,45,1
11.10.2025,2025,eurolig,162,Barcelona,Alba Berlin,88,73,19,16,24,21,20,17,25,19,35,45,37,44,-1
11.10.2025,2025,eurolig,160,Olimpia Milano,Paris,79,74,20,18,15,21,23,18,21,17,38,36,41,38,-1
11.10.2025,2025,eurolig,155,Olympiacos,Zalgiris Kaunas,74,68,21,6,14,18,17,19,22,25,27,32,36,47,1
11.10.2025,2025,rus,146,Temp Sumz Revda,x,71,73,16,21,19,15,23,25,13,12,37,34,48,25,-1
11.10.2025,2025,rus,147,Novosibirsk,x,59,78,12,20,15,11,15,26,17,21,32,26,41,38,1
11.10.2025,2025,rus,147,Lokomotiv Kuban 2,x,85,71,20,16,19,25,25,7,21,23,36,44,32,44,1
11.10.2025,2025,rus,150,Dome-Springs Izhevsk,x,62,76,15,22,23,21,9,16,15,17,37,44,25,32,-1
11.10.2025,2025,rus,151,Bars Rostov,x,75,64,12,19,22,15,22,15,19,15,31,37,37,34,-1
11.10.2025,2025,rus,151,Barnaul,x,80,69,30,23,12,16,18,13,20,17,53,28,31,37,-1
16.10.2025,2025,eurocup,165,BC Wolves,x,63,86,17,25,18,11,15,28,13,22,42,29,43,35,-1
16.10.2025,2025,eurocup,153,Hapoel Jerusalem,x,68,78,17,23,22,9,12,16,17,30,40,31,28,47,-1
16.10.2025,2025,eurocup,158,Trefl Sopot,x,92,83,29,20,19,10,15,22,29,31,49,29,37,60,1
16.10.2025,2025,eurocup,157,Trento,x,110,70,26,25,37,14,20,16,27,15,51,51,36,42,-1
15.10.2025,2025,eurocup,174,Cluj-Napoca,x,67,103,16,19,11,28,21,34,19,22,35,39,55,41,1
15.10.2025,2025,eurocup,154,Turk Telekom,x,67,63,15,11,23,22,9,16,20,14,26,45,25,34,-1
15.10.2025,2025,eurocup,166,Gran Canaria,x,79,66,16,14,21,15,24,19,18,18,30,36,43,36,-1
15.10.2025,2025,eurocup,162,Lietkabelis,x,76,72,18,10,25,13,17,27,16,22,28,38,44,38,1
14.10.2025,2025,eurocup,167,Ulm,x,107,74,31,9,30,19,28,21,18,25,40,49,49,43,1
16.10.2025,2025,champions,161,Benfica,x,103,75,32,17,25,16,22,21,24,21,49,41,43,45,1
16.10.2025,2025,champions,155,Tenerife,x,47,71,13,15,8,25,20,19,6,12,28,33,39,18,-1
16.10.2025,2025,champions,166,Slask Wroclaw,x,98,75,28,16,22,17,20,24,28,18,44,39,44,46,1
16.10.2025,2025,champions,157,Reggiana,x,78,71,17,13,17,19,23,22,21,17,30,36,45,38,1
15.10.2025,2025,champions,163,Manresa,x,102,85,30,16,25,22,25,21,22,26,46,47,46,48,1
15.10.2025,2025,champions,164,AEK Athens,x,93,74,26,17,13,19,20,23,34,15,43,32,43,49,1
15.10.2025,2025,champions,160,Saint Quentin,x,84,74,28,17,19,20,21,25,16,12,45,39,46,28,-1
15.10.2025,2025,champions,159,VEF Riga,x,78,71,20,13,18,17,13,25,27,16,33,35,38,43,1
16.10.2025,2025,fiba,159,Sporting CP,x,57,68,15,21,16,11,16,17,10,19,36,27,33,29,-1
16.10.2025,2025,fiba,161,Dijon,x,54,90,14,19,19,26,14,23,7,22,33,45,37,29,-1
16.10.2025,2025,fiba,159,Anwil Wloclawek,x,69,66,22,22,16,17,21,13,10,14,44,33,34,24,-1
16.10.2025,2025,fiba,165,Anorthosis,x,86,79,20,19,21,19,22,17,23,24,39,40,39,47,1
16.10.2025,2025,fiba,156,FC Porto,x,89,70,26,18,20,21,22,24,21,7,44,41,46,28,-1
16.10.2025,2025,fiba,161,BC Prievidza,x,70,89,11,26,17,23,18,23,24,17,37,40,41,41,1
16.10.2025,2025,fiba,161,CSM Constanta,x,103,76,20,24,32,24,22,14,29,14,44,56,36,43,-1
16.10.2025,2025,fiba,160,Spirou Charleroi,x,85,97,22,23,19,28,17,19,27,27,45,47,36,54,1
16.10.2025,2025,fiba,154,Arges Pitesti,x,65,62,19,15,13,10,19,19,14,18,34,23,38,32,-1
16.10.2025,2025,fiba,161,Ludwigsburg,x,57,70,21,21,11,14,13,12,12,23,42,25,25,35,-1
16.10.2025,2025,fiba,162,Basketball Braunschweig,x,95,94,22,28,19,20,21,25,18,7,50,39,46,25,-1
16.10.2025,2025,fiba,164,Tofas,x,69,96,20,27,16,25,20,23,13,21,47,41,43,34,-1
16.10.2025,2025,fiba,164,Bilbao,x,57,88,15,19,11,28,16,23,15,18,34,39,39,33,-1
16.10.2025,2025,fiba,149,CSM Oradea,x,72,84,13,23,23,16,16,21,20,24,36,39,37,44,1
16.10.2025,2025,fiba,150,Limburg,x,95,100,17,22,30,19,17,25,22,20,39,49,42,42,1
16.10.2025,2025,fiba,158,BC Kalev/Cramo,x,61,87,9,17,16,17,20,29,16,24,26,33,49,40,1
16.10.2025,2025,fiba,165,Maroussi,x,70,82,27,25,13,16,13,21,17,20,52,29,34,37,-1
15.10.2025,2025,fiba,159,Cholet,x,81,94,17,23,28,26,19,20,17,25,40,54,39,42,1
15.10.2025,2025,fiba,168,Alba Fehervar,x,104,73,23,24,25,20,27,18,29,11,47,45,45,40,1
15.10.2025,2025,fiba,168,Basket Zaragoza,x,96,80,24,21,25,10,25,15,22,34,45,35,40,56,1
16.10.2025,2025,aba 2,156,Siroki Brijeg,x,110,95,27,16,33,20,28,29,22,30,43,53,57,52,1
15.10.2025,2025,aba 2,152,Borac Banja Luka,x,90,93,23,26,14,25,24,19,20,11,49,39,43,31,-1
15.10.2025,2025,aba 2,156,Pelister,x,90,79,21,22,20,21,22,26,27,10,43,41,48,37,1
16.10.2025,2025,lat-st,168,Tal Tech,x,86,66,17,16,24,8,26,18,19,24,33,32,44,43,1
15.10.2025,2025,lat-st,165,Keila KK,x,100,73,26,24,26,15,29,15,19,19,50,41,44,38,-1
15.10.2025,2025,lat-st,150,Tartu Ulikool,x,89,87,22,17,20,12,20,19,14,28,39,32,39,42,1
16.10.2025,2025,fin,167,Helsinki Seagulls,x,58,97,17,19,17,25,7,20,17,33,36,42,27,50,-1
12.10.2025,2025,fin,163,UU-Korihait Uusikaupunki,x,81,98,26,34,15,23,22,21,18,20,60,38,43,38,-1
11.10.2025,2025,fin,161,Pyrinto Tampere,x,77,69,17,16,17,14,25,19,18,20,33,31,44,38,1
11.10.2025,2025,fin,165,Kataja,x,105,78,29,14,22,25,26,20,28,19,43,47,46,47,1
11.10.2025,2025,fin,159,Karhu Basket,x,97,88,23,21,22,20,22,25,30,22,44,42,47,52,1
11.10.2025,2025,fin,167,Kouvot Kouvola,x,101,107,17,25,26,25,23,23,25,18,42,51,46,43,1
11.10.2025,2025,fin,172,Salon Vilpas,x,82,96,14,21,24,23,24,22,20,30,35,47,46,50,1
16.10.2025,2025,ita b,156,Pesaro,x,71,50,18,9,20,15,11,14,22,12,27,35,25,34,-1
16.10.2025,2025,ita b,155,Sebastiani Rieti,x,66,71,22,18,14,17,16,21,14,15,40,31,37,29,-1
16.10.2025,2025,ita b,155,Nardo,x,84,68,30,15,14,15,28,19,12,19,45,29,47,31,1
16.10.2025,2025,ita b,154,JuVi Cremona,x,79,62,25,15,14,11,19,17,21,19,40,25,36,40,-1
16.10.2025,2025,ita b,155,Avellino Basket,x,83,92,23,22,24,24,10,23,26,23,45,48,33,49,1
16.10.2025,2025,ita b,151,Brindisi,x,82,61,18,11,19,14,26,17,19,19,29,33,43,38,1
16.10.2025,2025,ita b,150,Udine,x,75,73,19,23,18,19,22,19,16,12,42,37,41,28,-1
16.10.2025,2025,ita b,161,Cento,x,87,67,15,10,25,16,28,19,19,22,25,41,47,41,1
16.10.2025,2025,ita b,159,Rimini,x,81,98,26,36,20,22,15,17,20,23,62,42,32,43,-1
16.10.2025,2025,ita b,152,Cantu,x,77,80,29,17,20,21,20,29,8,13,46,41,49,21,-1
16.10.2025,2025,lat-st,171,Juventus,x,87,83,24,17,21,20,17,28,25,18,41,41,45,43,1
15.10.2025,2025,lat-st,165,Mazeikiai,x,89,71,26,26,19,21,28,8,16,16,52,40,36,32,-1
15.10.2025,2025,lat-st,177,Neptunas,x,88,84,25,27,19,24,28,11,16,22,52,43,39,38,-1
16.10.2025,2025,vtb,170,Uralmash Ekaterinburg,x,91,80,21,26,26,20,18,20,26,14,47,46,38,40,-1
16.10.2025,2025,vtb,145,Parma Perm,x,89,61,19,15,27,14,23,22,20,10,34,41,45,30,1
15.10.2025,2025,vtb,156,Astana,x,97,81,15,15,25,24,25,27,32,15,30,49,52,47,1
15.10.2025,2025,vtb,152,Nizhny Novgorod,x,87,89,21,16,25,23,21,27,20,23,37,48,48,43,1
15.10.2025,2025,vtb,154,MBA Moscow,x,68,76,16,25,15,17,18,14,19,20,41,32,32,39,-1
16.10.2025,2025,rus,146,Dynamo Grozny,x,80,76,18,17,13,21,20,23,29,15,35,34,43,44,1
16.10.2025,2025,rus,150,Zenit Petersburg 2,x,77,88,11,15,26,16,19,22,21,35,26,42,41,56,1
16.10.2025,2025,rus,145,Khimki M.,x,66,77,23,15,19,12,8,21,14,16,38,31,29,30,-1
16.10.2025,2025,rus,149,University-Ugra,x,75,62,20,17,21,9,16,13,18,23,37,30,29,41,-1
15.10.2025,2025,rus,140,Tambov,x,78,57,13,17,23,14,18,14,24,12,30,37,32,36,-1
15.10.2025,2025,rus,145,CSKA Moscow 2,x,65,76,22,24,20,20,6,23,17,9,46,40,29,26,-1
15.10.2025,2025,rus,145,Bars Rostov,x,65,80,23,20,21,16,7,19,14,25,43,37,26,39,-1
15.10.2025,2025,rus,154,Lokomotiv Kuban 2,x,80,75,14,16,22,13,17,21,27,25,30,35,38,52,1
16.10.2025,2025,sloven,152,Helios Domzale,x,86,66,18,24,23,19,15,11,30,12,42,42,26,42,-1
14.10.2025,2025,sloven,157,Rogaska,x,79,60,23,19,9,9,25,21,22,11,42,18,46,33,1
12.10.2025,2025,sloven,157,Tajfun Sentjur,x,95,61,23,14,18,18,24,13,30,16,37,36,37,46,1
12.10.2025,2025,sloven,158,Sencur,x,69,83,14,18,18,24,19,22,18,19,32,42,41,37,-1
12.10.2025,2025,sloven,149,KK Triglav Kranj,x,73,48,24,14,24,9,14,15,11,10,38,33,29,21,-1
11.10.2025,2025,sloven,160,Podcetrtek,x,75,79,21,21,11,25,19,14,24,19,42,36,33,43,-1
11.10.2025,2025,sloven,158,Ilirija,x,91,100,24,17,22,24,15,28,25,17,41,46,43,42,1
16.10.2025,2025,swit,162,SAM Massagno,x,63,73,12,23,27,18,12,12,12,20,35,45,24,32,-1
14.10.2025,2025,cro,155,Dubrava,x,101,72,25,14,26,16,26,22,24,20,39,42,48,44,1
14.10.2025,2025,cro,162,Split,x,83,95,25,22,24,31,10,23,24,19,47,55,33,43,-1
14.10.2025,2025,cro,156,Kvarner,x,76,81,14,19,23,15,17,14,13,19,33,38,31,32,-1
12.10.2025,2025,cro,163,Osijek,x,79,65,15,15,18,16,19,18,27,16,30,34,37,43,-1
12.10.2025,2025,cro,155,Zabok,x,82,76,22,16,16,21,21,32,23,7,38,37,53,30,1
12.10.2025,2025,cro,162,Cibona,x,78,91,29,20,15,13,15,31,19,27,49,28,46,46,1
12.10.2025,2025,lat nkl,163,Silute,x,81,77,26,27,19,10,23,14,13,26,53,29,37,39,-1
12.10.2025,2025,lat nkl,157,BC Olimpas Palanga,x,57,70,22,13,7,21,21,17,7,19,35,28,38,26,-1
12.10.2025,2025,lat nkl,155,Ukmerges Stekas,x,85,67,23,16,20,14,24,18,18,19,39,34,42,37,1
12.10.2025,2025,lat nkl,161,Kretinga,x,74,98,10,17,18,30,21,26,25,25,27,48,47,50,1
12.10.2025,2025,lat nkl,160,Suduva-Mantinga,x,84,96,19,28,24,27,27,23,14,18,47,51,50,32,1
12.10.2025,2025,lat nkl,164,Telsiai,x,108,100,21,17,21,21,16,25,31,26,38,42,41,57,1
12.10.2025,2025,lat nkl,150,Alytaus Alytus,x,78,68,26,17,15,13,27,17,10,21,43,28,44,31,-1
12.10.2025,2025,lat nkl,163,Omega-Tauras,x,86,64,24,13,25,18,20,15,17,18,37,43,35,35,-1
12.10.2025,2025,fra b,153,Caen,x,117,80,25,19,25,15,37,26,30,20,44,40,63,50,1
12.10.2025,2025,fra b,150,Orleans,x,85,78,19,22,17,19,19,20,30,17,41,36,39,47,1
11.10.2025,2025,fra b,161,Roanne,x,87,79,24,15,14,33,20,16,29,15,39,47,36,44,-1
11.10.2025,2025,fra b,153,Denain-Voltaire,x,89,85,26,19,17,22,15,14,31,30,45,39,29,61,1
11.10.2025,2025,fra b,167,Chalons-Reims,x,99,80,28,22,12,23,35,10,24,25,50,35,45,49,1
11.10.2025,2025,fra b,161,Chartres,x,97,87,29,26,25,18,22,23,21,20,55,43,45,41,1
11.10.2025,2025,fra b,166,Evreux,x,101,73,29,22,21,21,25,12,26,18,51,42,37,44,-1
11.10.2025,2025,fra b,162,ASA,x,85,97,19,26,22,26,21,20,23,25,45,48,41,48,1
11.10.2025,2025,fra b,158,Fos-sur-Mer,x,80,64,22,14,23,14,18,20,17,16,36,37,38,33,-1
11.10.2025,2025,fra b,158,Pau-Orthez,x,79,75,21,18,14,15,28,20,16,22,39,29,48,38,1
05.10.2025,2025,fra b,150,Antibes,x,69,72,16,23,18,18,16,18,19,13,39,36,34,32,-1
05.10.2025,2025,fra b,157,Rouen,x,75,67,19,21,12,11,21,18,23,17,40,23,39,40,1
04.10.2025,2025,fra b,164,Poitiers,x,83,80,24,27,25,22,19,16,15,15,51,47,35,30,-1
04.10.2025,2025,fra b,163,St. Chamond,x,79,99,18,25,20,30,21,28,20,16,43,50,49,36,1
04.10.2025,2025,fra b,156,Nantes,x,108,75,23,20,22,19,29,22,34,14,43,41,51,48,1
04.10.2025,2025,fra b,161,Aix Maurienne,x,77,72,13,19,26,21,24,15,14,17,32,47,39,31,-1
04.10.2025,2025,fra b,157,Vichy,x,81,73,22,26,20,14,23,8,16,25,48,34,31,41,-1
04.10.2025,2025,fra b,158,Orleans,x,88,97,22,24,20,22,28,28,18,23,46,42,56,41,1
04.10.2025,2025,fra b,162,Roanne,x,81,83,24,19,24,23,15,16,18,25,43,47,31,43,-1
04.10.2025,2025,fra b,158,Denain-Voltaire,x,72,81,11,19,26,19,15,20,20,23,30,45,35,43,-1
01.10.2025,2025,fra b,160,Rouen,x,92,84,18,27,33,19,22,18,19,20,45,52,40,39,-1
01.10.2025,2025,fra b,155,Vichy,x,87,80,15,18,20,19,31,24,21,19,33,39,55,40,1
01.10.2025,2025,fra b,167,Chartres,x,99,75,36,14,22,20,22,24,19,17,50,42,46,36,-1
01.10.2025,2025,fra b,164,Fos-sur-Mer,x,86,66,20,19,22,6,16,21,28,20,39,28,37,48,1
01.10.2025,2025,fra b,153,Hyeres-Toulon,x,68,62,12,14,23,9,13,27,20,12,26,32,40,32,-1
01.10.2025,2025,fra b,150,Boulazac,x,63,80,12,17,14,19,10,25,27,19,29,33,35,46,1
01.10.2025,2025,fra b,155,Pau-Orthez,x,84,89,20,18,29,21,15,28,20,22,38,50,43,42,1
01.10.2025,2025,fra b,159,Chalons-Reims,x,74,84,19,14,20,20,19,23,16,27,33,40,42,43,1
16.10.2025,2025,eurolig,160,Monaco,x,86,71,26,18,21,21,24,15,15,17,44,42,39,32,-1
15.10.2025,2025,eurolig,166,Bayern,x,86,78,24,15,25,17,22,20,15,26,39,42,42,41,-1
15.10.2025,2025,eurolig,170,Real Madrid,x,76,72,16,18,20,17,12,17,28,20,34,37,29,48,-1
15.10.2025,2025,eurolig,164,Panathinaikos,x,84,80,21,19,24,20,24,20,15,21,40,44,44,36,-1
15.10.2025,2025,eurolig,155,Zalgiris Kaunas,x,68,71,15,16,15,28,22,16,16,11,31,43,38,27,-1
15.10.2025,2025,eurolig,153,Olimpia Milano,x,89,68,23,17,16,10,24,21,26,20,40,26,45,46,1
15.10.2025,2025,eurolig,166,Anadolu Efes,x,93,91,23,24,29,28,20,22,21,17,47,57,42,38,-1
15.10.2025,2025,eurolig,160,Crvena zvezda,x,57,76,12,26,19,12,11,16,15,22,38,31,27,37,-1
15.10.2025,2025,eurolig,163,Lyon-Villeurbanne,x,84,79,20,13,16,23,28,18,20,25,33,39,46,45,1
11.10.2025,2025,eurolig,162,Alba Berlin,x,88,73,19,16,24,21,20,17,25,19,35,45,37,44,-1
11.10.2025,2025,eurolig,160,Paris,x,79,74,20,18,15,21,23,18,21,17,38,36,41,38,-1
11.10.2025,2025,eurolig,155,Zalgiris Kaunas,x,74,68,21,6,14,18,17,19,22,25,27,32,36,47,1
20.10.2025,2025,aba,155,KK Krka Novo mesto,Studentski Centar,97,91,15,22,26,24,26,20,30,25,37,50,46,55,1
20.10.2025,2025,aba,155,Zadar,Partizan,71,75,19,20,12,22,27,12,13,21,39,34,39,34,-1
20.10.2025,2025,aba,172,Dubai,Subotica,80,79,23,25,28,16,10,18,19,20,48,44,28,39,-1
19.10.2025,2025,aba,160,Split,Mega Basket,90,80,28,20,20,20,24,22,18,18,48,40,46,36,1
18.10.2025,2025,aba,159,Mornar Bar,Borac,90,98,20,17,18,26,23,21,26,23,37,44,44,49,1
18.10.2025,2025,aba,162,FMP Beograd,Cibona,89,84,27,28,17,24,23,15,22,17,55,41,38,39,-1
18.10.2025,2025,aba,159,Igokea,Cedevita Olimpija,91,78,28,21,22,23,24,12,17,22,49,45,36,39,-1
14.10.2025,2025,aba,164,Subotica,FMP Beograd,93,86,26,19,29,21,20,21,18,25,45,50,41,43,1
17.10.2025,2025,aba 2,158,GKK Sibenka,Ilirija,61,95,22,25,11,26,15,23,13,21,47,37,38,34,-1
20.10.2025,2025,aba,155,Studentski Centar,x,97,91,15,22,26,24,26,20,30,25,37,50,46,55,1
20.10.2025,2025,aba,155,Partizan,x,71,75,19,20,12,22,27,12,13,21,39,34,39,34,-1
20.10.2025,2025,aba,172,Subotica,x,80,79,23,25,28,16,10,18,19,20,48,44,28,39,-1
19.10.2025,2025,aba,160,Mega Basket,x,90,80,28,20,20,20,24,22,18,18,48,40,46,36,1
18.10.2025,2025,aba,159,Borac,x,90,98,20,17,18,26,23,21,26,23,37,44,44,49,1
18.10.2025,2025,aba,162,Cibona,x,89,84,27,28,17,24,23,15,22,17,55,41,38,39,-1
18.10.2025,2025,aba,159,Cedevita Olimpija,x,91,78,28,21,22,23,24,12,17,22,49,45,36,39,-1
14.10.2025,2025,aba,164,FMP Beograd,x,93,86,26,19,29,21,20,21,18,25,45,50,41,43,1
17.10.2025,2025,aba 2,158,Ilirija,x,61,95,22,25,11,26,15,23,13,21,47,37,38,34,-1
20.10.2025,2025,aus,154,Traiskirchen Lions,St. Polten,95,91,26,28,24,19,30,20,15,24,54,43,50,39,1
20.10.2025,2025,aus,162,Vienna Basket,BBC Nord,79,86,21,19,10,29,27,16,21,22,40,39,43,43,1
19.10.2025,2025,aus,154,Oberwart Gunners,Furstenfeld,91,48,20,11,27,7,31,16,13,14,31,34,47,27,-1
19.10.2025,2025,aus,156,Wels,Kapfenberg Bulls,70,68,19,21,25,16,12,13,14,18,40,41,25,32,-1
18.10.2025,2025,aus,162,Graz UBSC,Klosterneuburg Dukes,88,71,28,16,23,14,14,23,23,18,44,37,37,41,-1
20.10.2025,2025,aus,154,St. Polten,x,95,91,26,28,24,19,30,20,15,24,54,43,50,39,1
20.10.2025,2025,aus,162,BBC Nord,x,79,86,21,19,10,29,27,16,21,22,40,39,43,43,1
19.10.2025,2025,aus,154,Furstenfeld,x,91,48,20,11,27,7,31,16,13,14,31,34,47,27,-1
19.10.2025,2025,aus,156,Kapfenberg Bulls,x,70,68,19,21,25,16,12,13,14,18,40,41,25,32,-1
18.10.2025,2025,aus,162,Klosterneuburg Dukes,x,88,71,28,16,23,14,14,23,23,18,44,37,37,41,-1
20.10.2025,2025,avst,172,Adelaide,Tasmania JackJumpers,77,73,13,22,18,17,23,11,23,23,35,35,34,46,-1
20.10.2025,2025,avst,182,Melbourne United,South East Melbourne,84,93,18,16,25,32,20,18,21,27,34,57,38,48,-1
19.10.2025,2025,avst,184,Cairns Taipans,Illawarra Hawks,75,87,24,17,14,23,20,19,17,28,41,37,39,45,-1
19.10.2025,2025,avst,175,New Zealand Breakers,Perth,89,85,24,18,17,21,27,19,21,27,42,38,46,48,1
18.10.2025,2025,avst,173,Tasmania JackJumpers,Sydney,71,80,21,13,24,20,8,16,18,31,34,44,24,49,-1
17.10.2025,2025,avst,175,Brisbane Bullets,New Zealand Breakers,84,73,17,13,22,20,19,17,26,23,30,42,36,49,-1
20.10.2025,2025,avst,172,Tasmania JackJumpers,x,77,73,13,22,18,17,23,11,23,23,35,35,34,46,-1
20.10.2025,2025,avst,182,South East Melbourne,x,84,93,18,16,25,32,20,18,21,27,34,57,38,48,-1
19.10.2025,2025,avst,184,Illawarra Hawks,x,75,87,24,17,14,23,20,19,17,28,41,37,39,45,-1
19.10.2025,2025,avst,175,Perth,x,89,85,24,18,17,21,27,19,21,27,42,38,46,48,1
18.10.2025,2025,avst,173,Sydney,x,71,80,21,13,24,20,8,16,18,31,34,44,24,49,-1
17.10.2025,2025,avst,175,New Zealand Breakers,x,84,73,17,13,22,20,19,17,26,23,30,42,36,49,-1
18.10.2025,2025,bnxt,150,Circus Brussels,Leuven Bears,78,76,23,27,19,12,15,17,21,20,50,31,32,41,-1
18.10.2025,2025,bnxt,152,Limburg,BAL Weert,73,65,14,12,22,18,23,20,14,15,26,40,43,29,-1
18.10.2025,2025,bnxt,156,Mechelen,Antwerp Giants,76,79,24,19,21,20,14,17,17,23,43,41,31,40,-1
18.10.2025,2025,bnxt,170,Oostende,Kortrijk,86,80,20,24,21,20,17,19,28,17,44,41,36,45,-1
18.10.2025,2025,bnxt,156,Spirou Charleroi,Belfius Mons,60,50,12,5,21,7,12,25,15,13,17,28,37,28,-1
18.10.2025,2025,bnxt,153,Leiden,Zwolle,87,94,19,20,33,26,20,24,15,24,39,59,44,39,1
18.10.2025,2025,bnxt,165,LWD Basket,QSTA Utd,100,76,28,15,19,25,24,19,29,17,43,44,43,46,1
17.10.2025,2025,bnxt,163,Den Bosch,Feyenoord,81,92,15,21,19,22,27,27,20,22,36,41,54,42,1
17.10.2025,2025,bnxt,152,Den Helder,Donar Groningen,79,68,25,23,12,21,25,10,17,14,48,33,35,31,-1
20.10.2025,2025,bnxt,157,Mechelen,Spirou Charleroi,77,72,16,16,25,18,13,16,23,22,32,43,29,45,-1
20.10.2025,2025,bnxt,156,QSTA Utd,Leiden,71,76,14,21,15,21,19,18,23,16,35,36,37,39,-1
20.10.2025,2025,bnxt,154,Belfius Mons,Antwerp Giants,79,73,25,22,23,14,13,13,18,24,47,37,26,42,-1
20.10.2025,2025,bnxt,166,Kortrijk,Circus Brussels,79,80,20,17,23,14,15,26,21,23,37,37,41,44,1
20.10.2025,2025,bnxt,147,Leuven Bears,Limburg,85,68,18,7,30,24,14,18,23,19,25,54,32,42,1
20.10.2025,2025,bnxt,156,Okapi Aalst,Oostende,90,82,20,21,24,22,14,20,32,19,41,46,34,51,1
20.10.2025,2025,bnxt,158,Feyenoord,Den Helder,73,79,22,18,17,21,13,19,21,21,40,38,32,42,-1
20.10.2025,2025,bnxt,165,Zwolle,LWD Basket,70,91,29,21,13,22,21,24,7,24,50,35,45,31,-1
18.10.2025,2025,bnxt,150,Leuven Bears,x,78,76,23,27,19,12,15,17,21,20,50,31,32,41,-1
18.10.2025,2025,bnxt,152,BAL Weert,x,73,65,14,12,22,18,23,20,14,15,26,40,43,29,-1
18.10.2025,2025,bnxt,156,Antwerp Giants,x,76,79,24,19,21,20,14,17,17,23,43,41,31,40,-1
18.10.2025,2025,bnxt,170,Kortrijk,x,86,80,20,24,21,20,17,19,28,17,44,41,36,45,-1
18.10.2025,2025,bnxt,156,Belfius Mons,x,60,50,12,5,21,7,12,25,15,13,17,28,37,28,-1
18.10.2025,2025,bnxt,153,Zwolle,x,87,94,19,20,33,26,20,24,15,24,39,59,44,39,1
18.10.2025,2025,bnxt,165,QSTA Utd,x,100,76,28,15,19,25,24,19,29,17,43,44,43,46,1
17.10.2025,2025,bnxt,163,Feyenoord,x,81,92,15,21,19,22,27,27,20,22,36,41,54,42,1
17.10.2025,2025,bnxt,152,Donar Groningen,x,79,68,25,23,12,21,25,10,17,14,48,33,35,31,-1
20.10.2025,2025,bnxt,157,Spirou Charleroi,x,77,72,16,16,25,18,13,16,23,22,32,43,29,45,-1
20.10.2025,2025,bnxt,156,Leiden,x,71,76,14,21,15,21,19,18,23,16,35,36,37,39,-1
20.10.2025,2025,bnxt,154,Antwerp Giants,x,79,73,25,22,23,14,13,13,18,24,47,37,26,42,-1
20.10.2025,2025,bnxt,166,Circus Brussels,x,79,80,20,17,23,14,15,26,21,23,37,37,41,44,1
20.10.2025,2025,bnxt,147,Limburg,x,85,68,18,7,30,24,14,18,23,19,25,54,32,42,1
20.10.2025,2025,bnxt,156,Oostende,x,90,82,20,21,24,22,14,20,32,19,41,46,34,51,1
20.10.2025,2025,bnxt,158,Den Helder,x,73,79,22,18,17,21,13,19,21,21,40,38,32,42,-1
20.10.2025,2025,bnxt,165,LWD Basket,x,70,91,29,21,13,22,21,24,7,24,50,35,45,31,-1
20.10.2025,2025,bos,,Slavija,Siroki Brijeg,77,84,10,26,22,16,21,16,24,26,36,38,37,50,
20.10.2025,2025,bos,,Mrkonjic Grad,HKK Mostar,97,87,34,21,15,21,20,24,28,21,55,36,44,49,
20.10.2025,2025,bos,,Promo,Orlovik,78,71,26,23,15,18,22,22,15,8,49,33,44,23,
20.10.2025,2025,bos,,Borac Banja Luka,KK Bosna,80,83,20,22,20,20,24,16,16,25,42,40,40,41,
19.10.2025,2025,bos,,Leotar Trebinje,Sloboda,104,87,24,23,28,24,26,18,26,22,47,52,44,48,
19.10.2025,2025,bos,,Spars Ilidza,Posusje,72,65,24,23,10,13,20,14,18,15,47,23,34,33,
19.10.2025,2025,bos,,Jahorina,Radnicki Gorazde,86,72,20,20,23,19,27,16,16,17,40,42,43,33,
20.10.2025,2025,bos,,Siroki Brijeg,x,77,84,10,26,22,16,21,16,24,26,36,38,37,50,
20.10.2025,2025,bos,,HKK Mostar,x,97,87,34,21,15,21,20,24,28,21,55,36,44,49,
20.10.2025,2025,bos,,Orlovik,x,78,71,26,23,15,18,22,22,15,8,49,33,44,23,
20.10.2025,2025,bos,,KK Bosna,x,80,83,20,22,20,20,24,16,16,25,42,40,40,41,
19.10.2025,2025,bos,,Sloboda,x,104,87,24,23,28,24,26,18,26,22,47,52,44,48,
19.10.2025,2025,bos,,Posusje,x,72,65,24,23,10,13,20,14,18,15,47,23,34,33,
19.10.2025,2025,bos,,Radnicki Gorazde,x,86,72,20,20,23,19,27,16,16,17,40,42,43,33,
20.10.2025,2025,bul,163,Levski,Rilski Sportist,64,74,13,15,27,29,17,16,7,14,28,56,33,21,-1
20.10.2025,2025,bul,174,Shumen,Beroe,91,93,30,25,27,17,20,24,14,27,55,44,44,41,-1
18.10.2025,2025,bul,168,Academic Plovdiv,Cherno More,67,64,18,23,16,5,20,17,13,19,41,21,37,32,-1
18.10.2025,2025,bul,162,Spartak Pleven,Minyor,89,75,17,16,22,20,29,18,21,21,33,42,47,42,1
20.10.2025,2025,bul,163,Rilski Sportist,x,64,74,13,15,27,29,17,16,7,14,28,56,33,21,-1
20.10.2025,2025,bul,174,Beroe,x,91,93,30,25,27,17,20,24,14,27,55,44,44,41,-1
18.10.2025,2025,bul,168,Cherno More,x,67,64,18,23,16,5,20,17,13,19,41,21,37,32,-1
18.10.2025,2025,bul,162,Minyor,x,89,75,17,16,22,20,29,18,21,21,33,42,47,42,1
20.10.2025,2025,cek,175,Srsni Pisek,Opava,86,97,18,22,24,31,28,25,16,19,40,55,53,35,1
19.10.2025,2025,cek,160,Jindrichuv Hradec,Brno,99,89,21,18,22,12,17,18,16,28,39,34,35,44,-1
19.10.2025,2025,cek,164,Decin,Usti n. Labem,72,77,16,18,14,23,15,19,27,17,34,37,34,44,-1
19.10.2025,2025,cek,160,Olomoucko,Slavia Prague,96,90,19,20,17,17,18,19,19,17,39,34,37,36,-1
19.10.2025,2025,cek,174,NH Ostrava,Nymburk,65,92,17,18,22,23,21,24,5,27,35,45,45,32,-1
19.10.2025,2025,cek,160,USK Prague,Pardubice,94,82,26,25,33,16,17,22,18,19,51,49,39,37,-1
16.10.2025,2025,cek,166,Nymburk,Usti n. Labem,108,73,34,19,27,15,26,22,21,17,53,42,48,38,1
20.10.2025,2025,cek,175,Opava,x,86,97,18,22,24,31,28,25,16,19,40,55,53,35,1
19.10.2025,2025,cek,160,Brno,x,99,89,21,18,22,12,17,18,16,28,39,34,35,44,-1
19.10.2025,2025,cek,164,Usti n. Labem,x,72,77,16,18,14,23,15,19,27,17,34,37,34,44,-1
19.10.2025,2025,cek,160,Slavia Prague,x,96,90,19,20,17,17,18,19,19,17,39,34,37,36,-1
19.10.2025,2025,cek,174,Nymburk,x,65,92,17,18,22,23,21,24,5,27,35,45,45,32,-1
19.10.2025,2025,cek,160,Pardubice,x,94,82,26,25,33,16,17,22,18,19,51,49,39,37,-1
16.10.2025,2025,cek,166,Usti n. Labem,x,108,73,34,19,27,15,26,22,21,17,53,42,48,38,1
20.10.2025,2025,cro,161,Cibona,Dinamo Zagreb,101,85,25,28,27,17,22,15,27,25,53,44,37,52,1
20.10.2025,2025,cro,160,Dubrava,Alkar,83,69,23,11,19,15,24,24,17,19,34,34,48,36,1
19.10.2025,2025,cro,158,Dubrovnik,Cedevita Junior,63,84,22,14,12,23,7,27,22,20,36,35,34,42,-1
19.10.2025,2025,cro,162,Kvarner,Zabok,90,73,19,23,29,15,19,22,23,13,42,44,41,36,-1
17.10.2025,2025,cro,155,Zadar,Osijek,75,63,14,10,26,22,19,6,16,25,24,48,25,41,-1
20.10.2025,2025,cro,161,Dinamo Zagreb,x,101,85,25,28,27,17,22,15,27,25,53,44,37,52,1
20.10.2025,2025,cro,160,Alkar,x,83,69,23,11,19,15,24,24,17,19,34,34,48,36,1
19.10.2025,2025,cro,158,Cedevita Junior,x,63,84,22,14,12,23,7,27,22,20,36,35,34,42,-1
19.10.2025,2025,cro,162,Zabok,x,90,73,19,23,29,15,19,22,23,13,42,44,41,36,-1
17.10.2025,2025,cro,155,Osijek,x,75,63,14,10,26,22,19,6,16,25,24,48,25,41,-1
18.10.2025,2025,eurolig,166,Lyon-Villeurbanne,Baskonia,76,69,20,12,18,14,15,28,23,15,32,32,43,38,-1
18.10.2025,2025,eurolig,156,Crvena zvezda,Barcelona,94,98,25,26,22,18,19,19,18,21,51,40,38,39,-1
18.10.2025,2025,eurolig,158,Anadolu Efes,Olympiacos,91,89,11,23,30,21,24,26,26,19,34,51,50,45,1
18.10.2025,2025,eurolig,158,Monaco,Virtus Bologna,101,85,20,24,26,23,25,17,30,21,44,49,42,51,1
17.10.2025,2025,eurolig,166,Bayern,Paris,109,107,24,21,30,26,27,31,28,29,45,56,58,57,1
17.10.2025,2025,eurolig,168,Real Madrid,Panathinaikos,90,86,28,19,15,19,27,20,20,28,47,34,47,48,1
17.10.2025,2025,eurolig,151,Olimpia Milano,Zalgiris Kaunas,82,85,24,17,25,14,17,17,16,37,41,39,34,53,1
17.10.2025,2025,eurolig,170,Maccabi Tel Aviv,Partizan,79,91,27,28,19,14,18,24,15,25,55,33,42,40,-1
17.10.2025,2025,eurolig,162,Alba Berlin,Fenerbahce,71,78,16,15,15,23,16,20,24,20,31,38,36,44,-1
18.10.2025,2025,eurolig,166,Baskonia,x,76,69,20,12,18,14,15,28,23,15,32,32,43,38,-1
18.10.2025,2025,eurolig,156,Barcelona,x,94,98,25,26,22,18,19,19,18,21,51,40,38,39,-1
18.10.2025,2025,eurolig,158,Olympiacos,x,91,89,11,23,30,21,24,26,26,19,34,51,50,45,1
18.10.2025,2025,eurolig,158,Virtus Bologna,x,101,85,20,24,26,23,25,17,30,21,44,49,42,51,1
17.10.2025,2025,eurolig,166,Paris,x,109,107,24,21,30,26,27,31,28,29,45,56,58,57,1
17.10.2025,2025,eurolig,168,Panathinaikos,x,90,86,28,19,15,19,27,20,20,28,47,34,47,48,1
17.10.2025,2025,eurolig,151,Zalgiris Kaunas,x,82,85,24,17,25,14,17,17,16,37,41,39,34,53,1
17.10.2025,2025,eurolig,170,Partizan,x,79,91,27,28,19,14,18,24,15,25,55,33,42,40,-1
17.10.2025,2025,eurolig,162,Fenerbahce,x,71,78,16,15,15,23,16,20,24,20,31,38,36,44,-1
19.10.2025,2025,fin,167,Karhu Basket,Honka,85,63,27,17,23,20,23,17,12,9,44,43,40,21,-1
19.10.2025,2025,fin,168,Kataja,Kobrat,91,79,26,25,22,22,23,14,20,18,51,44,37,38,-1
19.10.2025,2025,fin,171,Salon Vilpas,KTP Kotka Basket,89,85,22,18,14,32,26,23,27,12,40,46,49,39,1
19.10.2025,2025,fin,162,Pyrinto Tampere,BC Nokia,96,87,24,19,32,17,18,33,22,18,43,49,51,40,1
18.10.2025,2025,fin,164,Kouvot Kouvola,Bisons Loimaa,65,81,11,13,18,21,18,27,18,20,24,39,45,38,1
19.10.2025,2025,fin,167,Honka,x,85,63,27,17,23,20,23,17,12,9,44,43,40,21,-1
19.10.2025,2025,fin,168,Kobrat,x,91,79,26,25,22,22,23,14,20,18,51,44,37,38,-1
19.10.2025,2025,fin,171,KTP Kotka Basket,x,89,85,22,18,14,32,26,23,27,12,40,46,49,39,1
19.10.2025,2025,fin,162,BC Nokia,x,96,87,24,19,32,17,18,33,22,18,43,49,51,40,1
18.10.2025,2025,fin,164,Bisons Loimaa,x,65,81,11,13,18,21,18,27,18,20,24,39,45,38,1
20.10.2025,2025,fra,170,Paris,Nanterre,102,86,30,19,22,15,27,21,23,31,49,37,48,54,1
20.10.2025,2025,fra,164,Chalon/Saone,Lyon-Villeurbanne,109,107,22,25,21,21,18,18,19,16,47,42,36,35,-1
20.10.2025,2025,fra,155,Monaco,Cholet,89,72,20,20,17,25,22,19,30,8,40,42,41,38,1
19.10.2025,2025,fra,159,Limoges,Le Mans,92,90,19,20,14,19,22,17,20,19,39,33,39,39,-1
19.10.2025,2025,fra,166,Strasbourg,Nancy,96,76,26,19,23,15,23,17,24,25,45,38,40,49,1
19.10.2025,2025,fra,160,JL Bourg,Dijon,88,91,16,20,23,21,25,12,16,27,36,44,37,43,-1
19.10.2025,2025,fra,145,La Rochelle,Saint Quentin,57,94,10,28,15,23,16,16,16,27,38,38,32,43,1
18.10.2025,2025,fra,154,Le Portel,Gravelines-Dunkerque,69,82,16,22,23,26,16,12,14,22,38,49,28,36,-1
20.10.2025,2025,fra,170,Nanterre,x,102,86,30,19,22,15,27,21,23,31,49,37,48,54,1
20.10.2025,2025,fra,164,Lyon-Villeurbanne,x,109,107,22,25,21,21,18,18,19,16,47,42,36,35,-1
20.10.2025,2025,fra,155,Cholet,x,89,72,20,20,17,25,22,19,30,8,40,42,41,38,1
19.10.2025,2025,fra,159,Le Mans,x,92,90,19,20,14,19,22,17,20,19,39,33,39,39,-1
19.10.2025,2025,fra,166,Nancy,x,96,76,26,19,23,15,23,17,24,25,45,38,40,49,1
19.10.2025,2025,fra,160,Dijon,x,88,91,16,20,23,21,25,12,16,27,36,44,37,43,-1
19.10.2025,2025,fra,145,Saint Quentin,x,57,94,10,28,15,23,16,16,16,27,38,38,32,43,1
18.10.2025,2025,fra,154,Gravelines-Dunkerque,x,69,82,16,22,23,26,16,12,14,22,38,49,28,36,-1
19.10.2025,2025,fra b,158,Orleans,Vichy,82,73,26,16,21,16,9,21,26,20,42,37,30,46,-1
19.10.2025,2025,fra b,155,Roanne,Boulazac,89,88,24,15,22,23,27,20,16,30,39,45,47,46,1
18.10.2025,2025,fra b,168,ASA,Aix Maurienne,100,89,28,16,14,21,17,20,22,24,44,35,37,46,-1
18.10.2025,2025,fra b,155,Caen,Antibes,73,79,21,24,22,13,20,25,10,17,45,35,45,27,-1
18.10.2025,2025,fra b,164,Chartres,Rouen,75,93,19,21,18,27,16,22,22,23,40,45,38,45,1
18.10.2025,2025,fra b,159,Denain-Voltaire,Poitiers,79,86,12,16,23,24,15,23,29,23,28,47,38,52,1
18.10.2025,2025,fra b,164,Evreux,Ada Blois,64,84,15,26,16,19,14,18,19,21,41,35,32,40,-1
18.10.2025,2025,fra b,155,Fos-sur-Mer,Chalons-Reims,95,72,21,20,24,16,23,25,27,11,41,40,48,38,1
18.10.2025,2025,fra b,162,Nantes,Hyeres-Toulon,69,73,22,17,14,24,11,17,22,15,39,38,28,37,-1
18.10.2025,2025,fra b,167,Pau-Orthez,St. Chamond,72,80,18,21,13,20,15,20,26,19,39,33,35,45,-1
19.10.2025,2025,fra b,158,Vichy,x,82,73,26,16,21,16,9,21,26,20,42,37,30,46,-1
19.10.2025,2025,fra b,155,Boulazac,x,89,88,24,15,22,23,27,20,16,30,39,45,47,46,1
18.10.2025,2025,fra b,168,Aix Maurienne,x,100,89,28,16,14,21,17,20,22,24,44,35,37,46,-1
18.10.2025,2025,fra b,155,Antibes,x,73,79,21,24,22,13,20,25,10,17,45,35,45,27,-1
18.10.2025,2025,fra b,164,Rouen,x,75,93,19,21,18,27,16,22,22,23,40,45,38,45,1
18.10.2025,2025,fra b,159,Poitiers,x,79,86,12,16,23,24,15,23,29,23,28,47,38,52,1
18.10.2025,2025,fra b,164,Ada Blois,x,64,84,15,26,16,19,14,18,19,21,41,35,32,40,-1
18.10.2025,2025,fra b,155,Chalons-Reims,x,95,72,21,20,24,16,23,25,27,11,41,40,48,38,1
18.10.2025,2025,fra b,162,Hyeres-Toulon,x,69,73,22,17,14,24,11,17,22,15,39,38,28,37,-1
18.10.2025,2025,fra b,167,St. Chamond,x,72,80,18,21,13,20,15,20,26,19,39,33,35,45,-1
20.10.2025,2025,ger b,161,Vechta 2,Koblenz,89,91,14,27,20,21,26,18,21,15,41,41,44,36,-1
20.10.2025,2025,ger b,165,Dresden,Tubingen,67,71,18,21,15,12,18,20,16,18,39,27,38,34,-1
19.10.2025,2025,ger b,171,Munster,Crailsheim Merlins,103,91,26,29,35,14,19,26,23,22,55,49,45,45,1
19.10.2025,2025,ger b,167,PS Karlsruhe,Artland,87,72,16,24,22,20,15,10,34,18,40,42,25,52,-1
19.10.2025,2025,ger b,165,Trier,Bremerhaven,68,87,17,24,25,19,10,18,16,26,41,44,28,42,-1
19.10.2025,2025,ger b,173,Bayreuth,Jena,74,90,18,28,22,17,18,21,16,24,46,39,39,40,-1
19.10.2025,2025,ger b,164,Dusseldorf,Giessen,51,102,14,27,13,26,17,26,7,23,41,39,43,30,-1
19.10.2025,2025,ger b,152,Kirchheim,Nurnberger,90,82,25,20,14,21,27,15,24,26,45,35,42,50,1
19.10.2025,2025,ger b,162,Phoenix Hagen,Bochum,87,73,20,22,32,13,15,24,20,14,42,45,39,34,-1
20.10.2025,2025,ger,167,Alba Berlin,Chemnitz,78,81,21,21,20,16,19,25,18,19,42,36,44,37,-1
20.10.2025,2025,ger,162,Bamberg,Rostock,75,89,24,23,12,17,20,26,19,23,47,29,46,42,1
20.10.2025,2025,ger,172,Heidelberg,Bonn,76,95,22,29,22,16,16,24,16,26,51,38,40,42,-1
19.10.2025,2025,ger,164,Ludwigsburg,Gottingen,91,62,19,13,30,20,14,17,28,12,32,50,31,40,-1
19.10.2025,2025,ger,168,Oldenburg,Ulm,93,66,25,14,21,15,25,12,22,25,39,36,37,47,-1
19.10.2025,2025,ger,157,Vechta,Frankfurt,74,80,24,21,11,21,23,16,16,22,45,32,39,38,-1
19.10.2025,2025,ger,165,Syntainics MBC,Bayern,79,75,17,19,23,16,19,20,20,20,36,39,39,40,-1
18.10.2025,2025,ger,166,Wurzburg,Hamburg,91,85,23,21,24,23,24,19,20,22,44,47,43,42,1
20.10.2025,2025,ger b,161,Koblenz,x,89,91,14,27,20,21,26,18,21,15,41,41,44,36,-1
20.10.2025,2025,ger b,165,Tubingen,x,67,71,18,21,15,12,18,20,16,18,39,27,38,34,-1
19.10.2025,2025,ger b,171,Crailsheim Merlins,x,103,91,26,29,35,14,19,26,23,22,55,49,45,45,1
19.10.2025,2025,ger b,167,Artland,x,87,72,16,24,22,20,15,10,34,18,40,42,25,52,-1
19.10.2025,2025,ger b,165,Bremerhaven,x,68,87,17,24,25,19,10,18,16,26,41,44,28,42,-1
19.10.2025,2025,ger b,173,Jena,x,74,90,18,28,22,17,18,21,16,24,46,39,39,40,-1
19.10.2025,2025,ger b,164,Giessen,x,51,102,14,27,13,26,17,26,7,23,41,39,43,30,-1
19.10.2025,2025,ger b,152,Nurnberger,x,90,82,25,20,14,21,27,15,24,26,45,35,42,50,1
19.10.2025,2025,ger b,162,Bochum,x,87,73,20,22,32,13,15,24,20,14,42,45,39,34,-1
20.10.2025,2025,ger,167,Chemnitz,x,78,81,21,21,20,16,19,25,18,19,42,36,44,37,-1
20.10.2025,2025,ger,162,Rostock,x,75,89,24,23,12,17,20,26,19,23,47,29,46,42,1
20.10.2025,2025,ger,172,Bonn,x,76,95,22,29,22,16,16,24,16,26,51,38,40,42,-1
19.10.2025,2025,ger,164,Gottingen,x,91,62,19,13,30,20,14,17,28,12,32,50,31,40,-1
19.10.2025,2025,ger,168,Ulm,x,93,66,25,14,21,15,25,12,22,25,39,36,37,47,-1
19.10.2025,2025,ger,157,Frankfurt,x,74,80,24,21,11,21,23,16,16,22,45,32,39,38,-1
19.10.2025,2025,ger,165,Bayern,x,79,75,17,19,23,16,19,20,20,20,36,39,39,40,-1
18.10.2025,2025,ger,166,Hamburg,x,91,85,23,21,24,23,24,19,20,22,44,47,43,42,1
21.10.2025,2025,greek,158,AS Karditsas,Olympiacos,61,77,14,19,14,27,18,16,15,15,33,41,34,30,-1
20.10.2025,2025,greek,157,Lavrio,Kolossos Rhodes,74,82,19,20,24,9,15,32,16,21,39,33,47,37,1
19.10.2025,2025,greek,153,Panionios,PAOK,73,62,15,20,19,11,20,19,19,12,35,30,39,31,-1
19.10.2025,2025,greek,160,Maroussi,Peristeri,73,79,16,19,18,24,13,20,26,16,35,42,33,42,-1
19.10.2025,2025,greek,155,Aris,Promitheas,86,75,23,11,20,26,19,16,24,22,34,46,35,46,1
14.10.2025,2025,greek,163,Promitheas,Lavrio,93,84,16,22,24,23,27,21,26,18,38,47,48,44,1
13.10.2025,2025,greek,151,Peristeri,Panionios,82,72,33,16,20,24,8,22,21,10,49,44,30,31,-1
13.10.2025,2025,greek,153,Olympiacos,Aris,102,72,35,12,22,19,19,18,26,23,47,41,37,49,1
12.10.2025,2025,greek,156,AEK Athens,AS Karditsas,96,65,23,9,27,24,19,14,27,18,32,51,33,45,-1
12.10.2025,2025,greek,160,Maroussi,Kolossos Rhodes,70,67,18,16,11,21,21,15,20,15,34,32,36,35,-1
12.10.2025,2025,greek,155,PAOK,Panathinaikos,93,96,22,21,20,23,28,20,23,32,43,43,48,55,1
07.10.2025,2025,greek,161,Lavrio,Olympiacos,75,93,22,19,21,21,21,29,11,24,41,42,50,35,1
21.10.2025,2025,greek,158,Olympiacos,x,61,77,14,19,14,27,18,16,15,15,33,41,34,30,-1
20.10.2025,2025,greek,157,Kolossos Rhodes,x,74,82,19,20,24,9,15,32,16,21,39,33,47,37,1
19.10.2025,2025,greek,153,PAOK,x,73,62,15,20,19,11,20,19,19,12,35,30,39,31,-1
19.10.2025,2025,greek,160,Peristeri,x,73,79,16,19,18,24,13,20,26,16,35,42,33,42,-1
19.10.2025,2025,greek,155,Promitheas,x,86,75,23,11,20,26,19,16,24,22,34,46,35,46,1
14.10.2025,2025,greek,163,Lavrio,x,93,84,16,22,24,23,27,21,26,18,38,47,48,44,1
13.10.2025,2025,greek,151,Panionios,x,82,72,33,16,20,24,8,22,21,10,49,44,30,31,-1
13.10.2025,2025,greek,153,Aris,x,102,72,35,12,22,19,19,18,26,23,47,41,37,49,1
12.10.2025,2025,greek,156,AS Karditsas,x,96,65,23,9,27,24,19,14,27,18,32,51,33,45,-1
12.10.2025,2025,greek,160,Kolossos Rhodes,x,70,67,18,16,11,21,21,15,20,15,34,32,36,35,-1
12.10.2025,2025,greek,155,Panathinaikos,x,93,96,22,21,20,23,28,20,23,32,43,43,48,55,1
07.10.2025,2025,greek,161,Olympiacos,x,75,93,22,19,21,21,21,29,11,24,41,42,50,35,1
20.10.2025,2025,ita,161,Trieste,Reggiana,85,97,25,19,25,30,21,28,14,20,44,55,49,34,1
20.10.2025,2025,ita,167,Treviso,Trento,76,83,16,23,16,25,24,18,20,17,39,41,42,37,-1
20.10.2025,2025,ita,158,Pistoia,Venezia,64,77,18,20,14,14,17,24,15,19,38,28,41,34,-1
20.10.2025,2025,ita,167,Scafati,Olimpia Milano,78,83,14,21,23,15,18,26,23,21,35,38,44,44,1
20.10.2025,2025,ita,168,Brescia,Sassari,94,87,17,21,28,13,27,16,22,37,38,41,43,59,1
19.10.2025,2025,ita,185,Varese,Trapani,100,109,33,24,24,28,21,27,22,30,57,52,48,52,1
19.10.2025,2025,ita,161,Basket Napoli,Cremona,81,87,21,24,23,19,21,14,16,30,45,42,35,46,1
20.10.2025,2025,ita b,149,Avellino Basket,Forli,64,73,14,14,18,20,17,17,15,22,28,38,34,37,-1
20.10.2025,2025,ita b,151,Cento,Basket Torino,67,74,11,15,13,9,21,23,22,27,26,22,44,49,1
20.10.2025,2025,ita b,162,JuVi Cremona,Orzinuovi,84,77,25,22,21,12,19,22,19,21,47,33,41,40,-1
20.10.2025,2025,ita b,148,Libertas Livorno,Cantu,80,83,24,25,20,27,19,11,17,20,49,47,30,37,-1
20.10.2025,2025,ita b,154,Nardo,Fortitudo Bologna,82,77,16,23,27,19,12,21,27,14,39,46,33,41,-1
20.10.2025,2025,ita b,157,Pesaro,Verona,63,73,20,25,19,16,14,14,10,18,45,35,28,28,-1
20.10.2025,2025,ita b,156,Rimini,Cividale,89,90,26,13,18,27,19,23,26,27,39,45,42,53,1
20.10.2025,2025,ita b,154,Udine,Urania Milano,75,74,14,16,20,18,14,24,27,16,30,38,38,43,1
20.10.2025,2025,ita b,159,Vigevano,Assigeco Piacenza,73,71,21,19,14,13,16,24,22,15,40,27,40,37,-1
20.10.2025,2025,ita,161,Reggiana,x,85,97,25,19,25,30,21,28,14,20,44,55,49,34,1
20.10.2025,2025,ita,167,Trento,x,76,83,16,23,16,25,24,18,20,17,39,41,42,37,-1
20.10.2025,2025,ita,158,Venezia,x,64,77,18,20,14,14,17,24,15,19,38,28,41,34,-1
20.10.2025,2025,ita,167,Olimpia Milano,x,78,83,14,21,23,15,18,26,23,21,35,38,44,44,1
20.10.2025,2025,ita,168,Sassari,x,94,87,17,21,28,13,27,16,22,37,38,41,43,59,1
19.10.2025,2025,ita,185,Trapani,x,100,109,33,24,24,28,21,27,22,30,57,52,48,52,1
19.10.2025,2025,ita,161,Cremona,x,81,87,21,24,23,19,21,14,16,30,45,42,35,46,1
20.10.2025,2025,ita b,149,Forli,x,64,73,14,14,18,20,17,17,15,22,28,38,34,37,-1
20.10.2025,2025,ita b,151,Basket Torino,x,67,74,11,15,13,9,21,23,22,27,26,22,44,49,1
20.10.2025,2025,ita b,162,Orzinuovi,x,84,77,25,22,21,12,19,22,19,21,47,33,41,40,-1
20.10.2025,2025,ita b,148,Cantu,x,80,83,24,25,20,27,19,11,17,20,49,47,30,37,-1
20.10.2025,2025,ita b,154,Fortitudo Bologna,x,82,77,16,23,27,19,12,21,27,14,39,46,33,41,-1
20.10.2025,2025,ita b,157,Verona,x,63,73,20,25,19,16,14,14,10,18,45,35,28,28,-1
20.10.2025,2025,ita b,156,Cividale,x,89,90,26,13,18,27,19,23,26,27,39,45,42,53,1
20.10.2025,2025,ita b,154,Urania Milano,x,75,74,14,16,20,18,14,24,27,16,30,38,38,43,1
20.10.2025,2025,ita b,159,Assigeco Piacenza,x,73,71,21,19,14,13,16,24,22,15,40,27,40,37,-1
21.10.2025,2025,kore,162,LG Sakers,KCC Egis,89,84,27,23,21,23,15,24,26,14,50,44,39,40,-1
20.10.2025,2025,kore,167,Mobis Phoebus,Goyang Sono,82,100,25,26,19,35,20,18,18,21,51,54,38,39,-1
20.10.2025,2025,kore,164,Seoul Knights,Anyang JungKwanJang,95,71,21,28,26,14,20,16,28,13,49,40,36,41,-1
20.10.2025,2025,kore,161,Suwon KT,Seoul Thunders,72,63,17,11,20,16,16,16,19,20,28,36,32,39,-1
19.10.2025,2025,kore,156,LG Sakers,KoGas,70,67,13,18,23,16,14,23,20,10,31,39,37,30,-1
19.10.2025,2025,kore,169,KCC Egis,Suwon KT,77,72,12,12,31,18,17,25,17,17,24,49,42,34,-1
19.10.2025,2025,kore,165,Wonju DB,Seoul Thunders,88,83,26,18,21,22,21,17,20,26,44,43,38,46,1
21.10.2025,2025,kore,162,KCC Egis,x,89,84,27,23,21,23,15,24,26,14,50,44,39,40,-1
20.10.2025,2025,kore,167,Goyang Sono,x,82,100,25,26,19,35,20,18,18,21,51,54,38,39,-1
20.10.2025,2025,kore,164,Anyang JungKwanJang,x,95,71,21,28,26,14,20,16,28,13,49,40,36,41,-1
20.10.2025,2025,kore,161,Seoul Thunders,x,72,63,17,11,20,16,16,16,19,20,28,36,32,39,-1
19.10.2025,2025,kore,156,KoGas,x,70,67,13,18,23,16,14,23,20,10,31,39,37,30,-1
19.10.2025,2025,kore,169,Suwon KT,x,77,72,12,12,31,18,17,25,17,17,24,49,42,34,-1
19.10.2025,2025,kore,165,Seoul Thunders,x,88,83,26,18,21,22,21,17,20,26,44,43,38,46,1
20.10.2025,2025,lat lkl,173,Nevezis,Rytas,83,93,26,21,22,32,23,20,12,20,47,54,43,32,-1
20.10.2025,2025,lat lkl,156,Zalgiris Kaunas,Lietkabelis,73,66,13,24,17,14,23,15,20,13,37,31,38,33,-1
19.10.2025,2025,lat lkl,167,BC Wolves,Juventus,67,72,18,15,16,20,19,23,14,14,33,36,42,28,-1
19.10.2025,2025,lat lkl,173,Siauliai,Neptunas,108,103,26,19,14,34,22,19,32,22,45,48,41,54,1
19.10.2025,2025,lat lkl,169,Jonava,Mazeikiai,103,83,26,17,19,23,31,13,27,30,43,42,44,57,1
20.10.2025,2025,lat-st,160,Keila Coolbet,Latvijas Universitate,83,75,19,21,21,21,23,16,20,17,40,42,39,37,-1
20.10.2025,2025,lat-st,157,Viimsi,Rigas Zelli,70,66,18,28,18,14,19,14,15,10,46,32,33,25,-1
19.10.2025,2025,lat-st,154,VEF Riga,Rapla,84,62,21,21,26,9,22,12,15,20,42,35,34,35,-1
19.10.2025,2025,lat-st,173,Keila KK,Tal Tech,66,77,15,11,21,26,18,21,12,19,26,47,39,31,-1
19.10.2025,2025,lat-st,160,BK Ogre,BC Kalev/Cramo,69,95,11,25,27,24,14,18,17,28,36,51,32,45,-1
19.10.2025,2025,lat-st,155,Parnu,BK Liepaja,81,91,20,19,17,31,33,22,11,19,39,48,55,30,1
18.10.2025,2025,lat-st,159,Tartu Ulikool,Rigas Zelli,77,71,20,10,19,20,12,18,26,23,30,39,30,49,-1
18.10.2025,2025,lat-st,164,Ventspils,Valmiera Glass Via,91,95,17,18,33,20,17,28,24,29,35,53,45,53,1
19.10.2025,2025,lat nkl,162,Kretinga,Neptunas 2,76,78,16,28,25,18,14,12,21,20,44,43,26,41,-1
19.10.2025,2025,lat nkl,163,Omega-Tauras,Jurbarkas,77,82,24,19,12,29,24,20,17,14,43,41,44,31,-1
19.10.2025,2025,lat nkl,167,Alytaus Alytus,Vytis VDU,77,109,23,23,20,27,14,28,20,31,46,47,42,51,1
19.10.2025,2025,lat nkl,153,BC Olimpas Palanga,Suduva-Mantinga,85,86,18,21,26,24,14,15,27,26,39,50,29,53,1
19.10.2025,2025,lat nkl,165,Rytas 2,Ukmerges Stekas,101,85,27,21,33,16,18,22,23,26,48,49,40,49,1
19.10.2025,2025,lat nkl,162,Silute,Plunges Olimpas,70,75,14,19,20,25,21,14,15,17,33,45,35,32,-1
19.10.2025,2025,lat nkl,158,Telsiai,Delikatesas Joniskis,107,94,19,18,25,23,31,25,32,28,37,48,56,60,1
19.10.2025,2025,lat nkl,152,Vilkaviskis,Zalgiris Kaunas 2,86,87,21,18,21,23,24,25,20,21,39,44,49,41,1
17.10.2025,2025,lat nkl,166,Jurbarkas,Vilkaviskis,88,86,23,26,23,26,23,17,19,17,49,49,40,36,-1
17.10.2025,2025,lat nkl,158,Plunges Olimpas,Alytaus Alytus,79,82,23,25,17,13,15,24,24,20,48,30,39,44,1
17.10.2025,2025,lat nkl,158,Rytas 2,BC Olimpas Palanga,79,88,16,21,17,15,25,23,21,29,37,32,48,50,1
17.10.2025,2025,lat nkl,163,Delikatesas Joniskis,Ukmerges Stekas,75,81,22,14,16,19,14,21,23,27,36,35,35,50,1
17.10.2025,2025,lat nkl,151,Neptunas 2,Telsiai,64,73,20,18,15,10,7,20,22,25,38,25,27,47,-1
17.10.2025,2025,lat nkl,158,Suduva-Mantinga,Omega-Tauras,69,86,12,23,28,19,16,20,13,24,35,47,36,37,-1
17.10.2025,2025,lat nkl,171,Vytis VDU,Kretinga,87,91,23,22,25,21,21,20,18,28,45,46,41,46,1
17.10.2025,2025,lat nkl,156,Zalgiris Kaunas 2,Silute,72,87,12,24,22,16,15,25,23,22,36,38,40,45,1
20.10.2025,2025,lat lkl,173,Rytas,x,83,93,26,21,22,32,23,20,12,20,47,54,43,32,-1
20.10.2025,2025,lat lkl,156,Lietkabelis,x,73,66,13,24,17,14,23,15,20,13,37,31,38,33,-1
19.10.2025,2025,lat lkl,167,Juventus,x,67,72,18,15,16,20,19,23,14,14,33,36,42,28,-1
19.10.2025,2025,lat lkl,173,Neptunas,x,108,103,26,19,14,34,22,19,32,22,45,48,41,54,1
19.10.2025,2025,lat lkl,169,Mazeikiai,x,103,83,26,17,19,23,31,13,27,30,43,42,44,57,1
20.10.2025,2025,lat-st,160,Latvijas Universitate,x,83,75,19,21,21,21,23,16,20,17,40,42,39,37,-1
20.10.2025,2025,lat-st,157,Rigas Zelli,x,70,66,18,28,18,14,19,14,15,10,46,32,33,25,-1
19.10.2025,2025,lat-st,154,Rapla,x,84,62,21,21,26,9,22,12,15,20,42,35,34,35,-1
19.10.2025,2025,lat-st,173,Tal Tech,x,66,77,15,11,21,26,18,21,12,19,26,47,39,31,-1
19.10.2025,2025,lat-st,160,BC Kalev/Cramo,x,69,95,11,25,27,24,14,18,17,28,36,51,32,45,-1
19.10.2025,2025,lat-st,155,BK Liepaja,x,81,91,20,19,17,31,33,22,11,19,39,48,55,30,1
18.10.2025,2025,lat-st,159,Rigas Zelli,x,77,71,20,10,19,20,12,18,26,23,30,39,30,49,-1
18.10.2025,2025,lat-st,164,Valmiera Glass Via,x,91,95,17,18,33,20,17,28,24,29,35,53,45,53,1
19.10.2025,2025,lat nkl,162,Neptunas 2,x,76,78,16,28,25,18,14,12,21,20,44,43,26,41,-1
19.10.2025,2025,lat nkl,163,Jurbarkas,x,77,82,24,19,12,29,24,20,17,14,43,41,44,31,-1
19.10.2025,2025,lat nkl,167,Vytis VDU,x,77,109,23,23,20,27,14,28,20,31,46,47,42,51,1
19.10.2025,2025,lat nkl,153,Suduva-Mantinga,x,85,86,18,21,26,24,14,15,27,26,39,50,29,53,1
19.10.2025,2025,lat nkl,165,Ukmerges Stekas,x,101,85,27,21,33,16,18,22,23,26,48,49,40,49,1
19.10.2025,2025,lat nkl,162,Plunges Olimpas,x,70,75,14,19,20,25,21,14,15,17,33,45,35,32,-1
19.10.2025,2025,lat nkl,158,Delikatesas Joniskis,x,107,94,19,18,25,23,31,25,32,28,37,48,56,60,1
19.10.2025,2025,lat nkl,152,Zalgiris Kaunas 2,x,86,87,21,18,21,23,24,25,20,21,39,44,49,41,1
17.10.2025,2025,lat nkl,166,Vilkaviskis,x,88,86,23,26,23,26,23,17,19,17,49,49,40,36,-1
17.10.2025,2025,lat nkl,158,Alytaus Alytus,x,79,82,23,25,17,13,15,24,24,20,48,30,39,44,1
17.10.2025,2025,lat nkl,158,BC Olimpas Palanga,x,79,88,16,21,17,15,25,23,21,29,37,32,48,50,1
17.10.2025,2025,lat nkl,163,Ukmerges Stekas,x,75,81,22,14,16,19,14,21,23,27,36,35,35,50,1
17.10.2025,2025,lat nkl,151,Telsiai,x,64,73,20,18,15,10,7,20,22,25,38,25,27,47,-1
17.10.2025,2025,lat nkl,158,Omega-Tauras,x,69,86,12,23,28,19,16,20,13,24,35,47,36,37,-1
17.10.2025,2025,lat nkl,171,Kretinga,x,87,91,23,22,25,21,21,20,18,28,45,46,41,46,1
17.10.2025,2025,lat nkl,156,Silute,x,72,87,12,24,22,16,15,25,23,22,36,38,40,45,1
19.10.2025,2025,mac,162,Szedeak,OSE Lions,80,69,20,12,22,23,14,16,24,18,32,45,30,42,-1
19.10.2025,2025,mac,155,Szolnoki Olaj,Budapesti Honved Se,83,72,20,11,27,20,13,26,23,15,31,47,39,38,-1
19.10.2025,2025,mac,164,Szombathely,Atomeromu Paks,87,77,29,16,6,19,27,23,25,19,45,25,50,44,1
19.10.2025,2025,mac,182,Alba Fehervar,Zalakeramia,97,92,27,25,17,24,25,17,28,26,52,41,42,54,1
18.10.2025,2025,mac,164,Pecsi VSK,NKA Pecs,91,94,24,24,27,18,21,25,19,27,48,45,46,46,1
16.10.2025,2025,mac,159,KTE-Duna,Soproni KC,75,72,23,12,11,20,19,17,22,23,35,31,36,45,1
19.10.2025,2025,mac,164,DEAC,x,80,85,18,28,23,14,13,15,26,28,46,37,28,54,-1
19.10.2025,2025,mac,162,OSE Lions,x,80,69,20,12,22,23,14,16,24,18,32,45,30,42,-1
19.10.2025,2025,mac,155,Budapesti Honved Se,x,83,72,20,11,27,20,13,26,23,15,31,47,39,38,-1
19.10.2025,2025,mac,164,Atomeromu Paks,x,87,77,29,16,6,19,27,23,25,19,45,25,50,44,1
19.10.2025,2025,mac,182,Zalakeramia,x,97,92,27,25,17,24,25,17,28,26,52,41,42,54,1
18.10.2025,2025,mac,164,NKA Pecs,x,91,94,24,24,27,18,21,25,19,27,48,45,46,46,1
16.10.2025,2025,mac,159,Soproni KC,x,75,72,23,12,11,20,19,17,22,23,35,31,36,45,1
19.10.2025,2025,mak,159,Cair 2030,Shkupi Skopje,98,80,27,15,25,22,23,23,23,20,42,47,46,43,1
19.10.2025,2025,mak,155,Rabotnicki,MZT Skopje,56,70,8,28,20,20,14,12,14,10,36,40,26,24,-1
19.10.2025,2025,mak,156,Tikvesh,Gostivar,80,75,19,21,25,12,18,20,18,22,40,37,38,40,-1
19.10.2025,2025,mak,159,Vardar,Feniks 2010,72,77,23,18,19,24,13,15,17,20,41,43,28,37,-1
19.10.2025,2025,mak,154,TFT Skopje,Kozuv,79,77,19,16,17,15,15,18,28,28,35,32,33,56,1
19.10.2025,2025,mak,159,Shkupi Skopje,x,98,80,27,15,25,22,23,23,23,20,42,47,46,43,1
19.10.2025,2025,mak,155,MZT Skopje,x,56,70,8,28,20,20,14,12,14,10,36,40,26,24,-1
19.10.2025,2025,mak,156,Gostivar,x,80,75,19,21,25,12,18,20,18,22,40,37,38,40,-1
19.10.2025,2025,mak,159,Feniks 2010,x,72,77,23,18,19,24,13,15,17,20,41,43,28,37,-1
19.10.2025,2025,mak,154,Kozuv,x,79,77,19,16,17,15,15,18,28,28,35,32,33,56,1
21.10.2025,2025,pol,156,Torun,Dziki Warszawa,90,94,25,26,14,26,24,20,27,22,51,40,44,49,1
20.10.2025,2025,pol,154,Czarni Slupsk,Anwil Wloclawek,86,104,22,28,20,26,20,19,24,31,50,46,39,55,1
20.10.2025,2025,pol,157,Spojnia Stargard,Ostrow Wielkopolski,79,73,19,23,19,16,16,21,25,13,42,35,37,38,-1
20.10.2025,2025,pol,165,GTK Gliwice,Dabrowa Gornicza,81,79,20,24,16,17,24,17,21,21,44,33,41,42,1
20.10.2025,2025,pol,171,Gdynia,Szczecin,83,79,19,15,20,22,20,24,24,18,34,42,44,42,1
20.10.2025,2025,pol,164,Zielona Gora,Legia,84,94,27,29,28,26,6,29,23,10,56,54,35,33,-1
19.10.2025,2025,pol,164,Slask Wroclaw,Trefl Sopot,72,87,23,17,20,25,13,17,16,28,40,45,30,44,-1
18.10.2025,2025,pol,165,Lublin,Gornik Walbrzych,84,93,31,26,16,26,25,25,12,16,57,42,50,28,-1
14.10.2025,2025,pol,165,Szczecin,GTK Gliwice,97,76,20,17,28,26,23,13,26,20,37,54,36,46,-1
21.10.2025,2025,pol,156,Dziki Warszawa,x,90,94,25,26,14,26,24,20,27,22,51,40,44,49,1
20.10.2025,2025,pol,154,Anwil Wloclawek,x,86,104,22,28,20,26,20,19,24,31,50,46,39,55,1
20.10.2025,2025,pol,157,Ostrow Wielkopolski,x,79,73,19,23,19,16,16,21,25,13,42,35,37,38,-1
20.10.2025,2025,pol,165,Dabrowa Gornicza,x,81,79,20,24,16,17,24,17,21,21,44,33,41,42,1
20.10.2025,2025,pol,171,Szczecin,x,83,79,19,15,20,22,20,24,24,18,34,42,44,42,1
20.10.2025,2025,pol,164,Legia,x,84,94,27,29,28,26,6,29,23,10,56,54,35,33,-1
19.10.2025,2025,pol,164,Trefl Sopot,x,72,87,23,17,20,25,13,17,16,28,40,45,30,44,-1
18.10.2025,2025,pol,165,Gornik Walbrzych,x,84,93,31,26,16,26,25,25,12,16,57,42,50,28,-1
14.10.2025,2025,pol,165,GTK Gliwice,x,97,76,20,17,28,26,23,13,26,20,37,54,36,46,-1
20.10.2025,2025,por,153,Esgueira,Sporting CP,82,81,12,19,21,20,17,20,32,22,31,41,37,54,1
19.10.2025,2025,por,155,CA Queluz,CD Povoa,76,71,20,29,24,18,19,11,13,13,49,42,30,26,-1
19.10.2025,2025,por,159,Imortal,Benfica,61,96,12,26,16,16,20,31,13,23,38,32,51,36,1
19.10.2025,2025,por,156,Ovarense,Galitos Barreiro,72,59,12,12,17,9,20,22,23,16,24,26,42,39,1
19.10.2025,2025,por,147,Galomar,Oliveirense,61,95,15,23,20,23,12,25,14,24,38,43,37,38,1
19.10.2025,2025,por,160,FC Porto,Vitoria,88,80,24,17,18,19,23,16,23,28,41,37,39,51,1
20.10.2025,2025,por,153,Sporting CP,x,82,81,12,19,21,20,17,20,32,22,31,41,37,54,1
19.10.2025,2025,por,155,CD Povoa,x,76,71,20,29,24,18,19,11,13,13,49,42,30,26,-1
19.10.2025,2025,por,159,Benfica,x,61,96,12,26,16,16,20,31,13,23,38,32,51,36,1
19.10.2025,2025,por,156,Galitos Barreiro,x,72,59,12,12,17,9,20,22,23,16,24,26,42,39,1
19.10.2025,2025,por,147,Oliveirense,x,61,95,15,23,20,23,12,25,14,24,38,43,37,38,1
19.10.2025,2025,por,160,Vitoria,x,88,80,24,17,18,19,23,16,23,28,41,37,39,51,1
20.10.2025,2025,por b,146,Imortal B,CAB Madeira,48,74,5,24,15,15,18,16,10,19,29,30,34,29,-1
19.10.2025,2025,por b,139,Galitos Aveiro,Sangalhos,56,68,19,18,7,15,13,17,17,18,37,22,30,35,-1
19.10.2025,2025,por b,144,Barreirense,Benfica Lisboa B,70,68,17,19,20,9,11,10,15,25,36,29,21,40,-1
19.10.2025,2025,por b,149,Illiabum,Braga,69,67,22,16,14,22,17,15,16,14,38,36,32,30,-1
19.10.2025,2025,por b,149,Maia,Ginasio,86,79,22,18,28,27,18,17,18,17,40,55,35,35,-1
19.10.2025,2025,por b,141,Lusitania,Portimonense,74,97,15,20,30,26,17,28,12,23,35,56,45,35,1
19.10.2025,2025,por b,155,Sampaense,Vasco Da Gama,80,78,23,12,19,19,18,27,20,20,35,38,45,40,1
19.10.2025,2025,por b,139,CB Queluz,Santo Andre,59,75,15,25,11,16,14,19,19,15,40,27,33,34,-1
13.10.2025,2025,por b,148,Imortal B,Portimonense,76,68,27,22,19,17,9,14,21,15,49,36,23,36,-1
13.10.2025,2025,por b,145,Benfica Lisboa B,CB Queluz,84,65,21,15,26,20,20,10,17,20,36,46,30,37,-1
20.10.2025,2025,por b,146,CAB Madeira,x,48,74,5,24,15,15,18,16,10,19,29,30,34,29,-1
19.10.2025,2025,por b,139,Sangalhos,x,56,68,19,18,7,15,13,17,17,18,37,22,30,35,-1
19.10.2025,2025,por b,144,Benfica Lisboa B,x,70,68,17,19,20,9,11,10,15,25,36,29,21,40,-1
19.10.2025,2025,por b,149,Braga,x,69,67,22,16,14,22,17,15,16,14,38,36,32,30,-1
19.10.2025,2025,por b,149,Ginasio,x,86,79,22,18,28,27,18,17,18,17,40,55,35,35,-1
19.10.2025,2025,por b,141,Portimonense,x,74,97,15,20,30,26,17,28,12,23,35,56,45,35,1
19.10.2025,2025,por b,155,Vasco Da Gama,x,80,78,23,12,19,19,18,27,20,20,35,38,45,40,1
19.10.2025,2025,por b,139,Santo Andre,x,59,75,15,25,11,16,14,19,19,15,40,27,33,34,-1
13.10.2025,2025,por b,148,Portimonense,x,76,68,27,22,19,17,9,14,21,15,49,36,23,36,-1
13.10.2025,2025,por b,145,CB Queluz,x,84,65,21,15,26,20,20,10,17,20,36,46,30,37,-1
20.10.2025,2025,sır,165,OKK Beograd,Vojvodina Novi Sad,64,99,15,28,16,23,19,20,14,28,43,39,39,42,-1
20.10.2025,2025,sır,162,Dynamic,Vrsac,109,80,26,19,29,19,26,24,28,18,45,48,50,46,1
19.10.2025,2025,sır,165,KK Mladost SP,Radnicki,79,72,19,24,22,7,12,19,10,13,43,29,31,23,-1
19.10.2025,2025,sır,163,Sloboda,KK Metalac,99,71,23,24,28,6,25,19,23,22,47,34,44,45,1
19.10.2025,2025,sır,160,Tamis,BBK Radnicki,76,70,18,14,17,17,24,21,17,18,32,34,45,35,-1
19.10.2025,2025,sır,162,Zlatibor,Sloga,96,80,23,24,25,16,21,22,27,18,47,41,43,45,1
19.10.2025,2025,sır,162,Cacak 94,Joker,71,72,22,18,17,15,21,18,11,21,40,32,39,32,-1
20.10.2025,2025,sır,165,Vojvodina Novi Sad,x,64,99,15,28,16,23,19,20,14,28,43,39,39,42,-1
20.10.2025,2025,sır,162,Vrsac,x,109,80,26,19,29,19,26,24,28,18,45,48,50,46,1
19.10.2025,2025,sır,165,Radnicki,x,79,72,19,24,22,7,12,19,10,13,43,29,31,23,-1
19.10.2025,2025,sır,163,KK Metalac,x,99,71,23,24,28,6,25,19,23,22,47,34,44,45,1
19.10.2025,2025,sır,160,BBK Radnicki,x,76,70,18,14,17,17,24,21,17,18,32,34,45,35,-1
19.10.2025,2025,sır,162,Sloga,x,96,80,23,24,25,16,21,22,27,18,47,41,43,45,1
19.10.2025,2025,sır,162,Joker,x,71,72,22,18,17,15,21,18,11,21,40,32,39,32,-1
19.10.2025,2025,rus,153,Dome-Springs Izhevsk,Zenit Petersburg 2,72,67,22,14,16,19,15,19,19,15,36,35,34,34,-1
19.10.2025,2025,rus,151,Temp Sumz Revda,Dynamo Grozny,90,83,20,19,22,25,23,26,25,13,39,47,49,38,1
19.10.2025,2025,rus,143,Barnaul,Khimki M.,77,83,6,32,19,13,22,20,30,18,38,32,42,48,1
19.10.2025,2025,rus,145,Novosibirsk,University-Ugra,75,47,22,11,19,10,19,5,15,21,33,29,24,36,-1
18.10.2025,2025,rus,142,Chelyabinsk,CSKA Moscow 2,76,73,16,23,21,21,19,18,20,11,39,42,37,31,-1
18.10.2025,2025,rus,145,Metallurg,Tambov,62,76,17,16,17,21,12,22,16,17,33,38,34,33,-1
18.10.2025,2025,rus,147,Irkutsk,Lokomotiv Kuban 2,88,75,22,22,19,20,26,13,21,20,44,39,39,41,1
18.10.2025,2025,rus,148,Dynamo Vladivostok,Bars Rostov,84,67,25,18,21,14,25,13,13,22,43,35,38,35,-1
16.10.2025,2025,rus,146,Dome-Springs Izhevsk,Dynamo Grozny,80,76,18,17,13,21,20,23,29,15,35,34,43,44,1
16.10.2025,2025,rus,151,Temp Sumz Revda,Zenit Petersburg 2,77,88,11,15,26,16,19,22,21,35,26,42,41,56,1
16.10.2025,2025,rus,145,Novosibirsk,Khimki M.,66,77,23,15,19,12,8,21,14,16,38,31,29,30,-1
16.10.2025,2025,rus,149,Barnaul,University-Ugra,75,62,20,17,21,9,16,13,18,23,37,30,29,41,-1
15.10.2025,2025,rus,140,Chelyabinsk,Tambov,78,57,13,17,23,14,18,14,24,12,30,37,32,36,-1
15.10.2025,2025,rus,145,Metallurg,CSKA Moscow 2,65,76,22,24,20,20,6,23,17,9,46,40,29,26,-1
15.10.2025,2025,rus,144,Irkutsk,Bars Rostov,65,80,23,20,21,16,7,19,14,25,43,37,26,39,-1
15.10.2025,2025,rus,154,Dynamo Vladivostok,Lokomotiv Kuban 2,80,75,14,16,22,13,17,21,27,25,30,35,38,52,1
19.10.2025,2025,rus,153,Zenit Petersburg 2,x,72,67,22,14,16,19,15,19,19,15,36,35,34,34,-1
19.10.2025,2025,rus,151,Dynamo Grozny,x,90,83,20,19,22,25,23,26,25,13,39,47,49,38,1
19.10.2025,2025,rus,143,Khimki M.,x,77,83,6,32,19,13,22,20,30,18,38,32,42,48,1
19.10.2025,2025,rus,145,University-Ugra,x,75,47,22,11,19,10,19,5,15,21,33,29,24,36,-1
18.10.2025,2025,rus,142,CSKA Moscow 2,x,76,73,16,23,21,21,19,18,20,11,39,42,37,31,-1
18.10.2025,2025,rus,145,Tambov,x,62,76,17,16,17,21,12,22,16,17,33,38,34,33,-1
18.10.2025,2025,rus,147,Lokomotiv Kuban 2,x,88,75,22,22,19,20,26,13,21,20,44,39,39,41,1
18.10.2025,2025,rus,148,Bars Rostov,x,84,67,25,18,21,14,25,13,13,22,43,35,38,35,-1
16.10.2025,2025,rus,146,Dynamo Grozny,x,80,76,18,17,13,21,20,23,29,15,35,34,43,44,1
16.10.2025,2025,rus,151,Zenit Petersburg 2,x,77,88,11,15,26,16,19,22,21,35,26,42,41,56,1
16.10.2025,2025,rus,145,Khimki M.,x,66,77,23,15,19,12,8,21,14,16,38,31,29,30,-1
16.10.2025,2025,rus,149,University-Ugra,x,75,62,20,17,21,9,16,13,18,23,37,30,29,41,-1
15.10.2025,2025,rus,140,Tambov,x,78,57,13,17,23,14,18,14,24,12,30,37,32,36,-1
15.10.2025,2025,rus,145,CSKA Moscow 2,x,65,76,22,24,20,20,6,23,17,9,46,40,29,26,-1
15.10.2025,2025,rus,144,Bars Rostov,x,65,80,23,20,21,16,7,19,14,25,43,37,26,39,-1
15.10.2025,2025,rus,154,Lokomotiv Kuban 2,x,80,75,14,16,22,13,17,21,27,25,30,35,38,52,1
21.10.2025,2025,sloven,158,Podcetrtek,Zlatorog Lasko,84,78,25,12,25,24,17,24,17,18,37,49,41,35,-1
20.10.2025,2025,sloven,154,Rogaska,Tajfun Sentjur,75,79,18,22,22,23,20,15,15,19,40,45,35,34,-1
20.10.2025,2025,sloven,150,KK Triglav Kranj,Ilirija,69,78,18,17,16,27,18,18,17,16,35,43,36,33,-1
18.10.2025,2025,sloven,158,Sencur,LTH Castings,77,64,27,22,17,11,18,12,15,19,49,28,30,34,-1
21.10.2025,2025,sloven,158,Zlatorog Lasko,x,84,78,25,12,25,24,17,24,17,18,37,49,41,35,-1
20.10.2025,2025,sloven,154,Tajfun Sentjur,x,75,79,18,22,22,23,20,15,15,19,40,45,35,34,-1
20.10.2025,2025,sloven,150,Ilirija,x,69,78,18,17,16,27,18,18,17,16,35,43,36,33,-1
18.10.2025,2025,sloven,158,LTH Castings,x,77,64,27,22,17,11,18,12,15,19,49,28,30,34,-1
20.10.2025,2025,slovak,165,BC Komarno,BC Prievidza,87,84,20,21,24,21,22,22,21,20,41,45,44,41,1
19.10.2025,2025,slovak,165,BKM Lucenec,Nitra Blue Wings,70,108,13,24,23,34,17,18,17,32,37,57,35,49,1
19.10.2025,2025,slovak,168,Iskra Svit,Inter Bratislava,74,87,23,20,10,20,22,28,19,19,43,30,50,38,1
19.10.2025,2025,slovak,169,Levice,SPU Nitra,92,64,28,15,23,18,20,13,21,18,43,41,33,39,-1
19.10.2025,2025,slovak,163,MBK Handlova,Spisski Rytieri,97,71,21,21,25,11,26,14,25,25,42,36,40,50,1
12.10.2025,2025,slovak,168,BC Prievidza,BKM Lucenec,95,72,26,21,18,20,27,18,24,13,47,38,45,37,-1
12.10.2025,2025,slovak,171,Spisski Rytieri,Levice,87,85,29,19,27,14,15,25,16,27,48,41,40,43,-1
12.10.2025,2025,slovak,162,Inter Bratislava,MBK Handlova,61,64,10,10,19,18,13,21,19,15,20,37,34,34,-1
12.10.2025,2025,slovak,175,BC Komarno,SPU Nitra,91,67,26,15,23,11,19,26,23,15,41,34,45,38,-1
12.10.2025,2025,slovak,168,Nitra Blue Wings,Iskra Svit,92,67,28,27,24,11,23,10,17,19,55,35,33,36,-1
20.10.2025,2025,slovak,165,BC Prievidza,x,87,84,20,21,24,21,22,22,21,20,41,45,44,41,1
19.10.2025,2025,slovak,165,Nitra Blue Wings,x,70,108,13,24,23,34,17,18,17,32,37,57,35,49,1
19.10.2025,2025,slovak,168,Inter Bratislava,x,74,87,23,20,10,20,22,28,19,19,43,30,50,38,1
19.10.2025,2025,slovak,169,SPU Nitra,x,92,64,28,15,23,18,20,13,21,18,43,41,33,39,-1
19.10.2025,2025,slovak,163,Spisski Rytieri,x,97,71,21,21,25,11,26,14,25,25,42,36,40,50,1
12.10.2025,2025,slovak,168,BKM Lucenec,x,95,72,26,21,18,20,27,18,24,13,47,38,45,37,-1
12.10.2025,2025,slovak,171,Levice,x,87,85,29,19,27,14,15,25,16,27,48,41,40,43,-1
12.10.2025,2025,slovak,162,MBK Handlova,x,61,64,10,10,19,18,13,21,19,15,20,37,34,34,-1
12.10.2025,2025,slovak,175,SPU Nitra,x,91,67,26,15,23,11,19,26,23,15,41,34,45,38,-1
12.10.2025,2025,slovak,168,Iskra Svit,x,92,67,28,27,24,11,23,10,17,19,55,35,33,36,-1
19.10.2025,2025,rom,155,Rapid Bucuresti,BC Steaua Bucuresti,86,69,26,12,23,21,17,23,20,13,38,44,40,33,-1
19.10.2025,2025,rom,152,Arges Pitesti,CSM Oradea,67,76,14,22,20,13,21,18,12,23,36,33,39,35,-1
19.10.2025,2025,rom,168,CSM Constanta,Cluj-Napoca,85,114,15,26,25,25,23,26,22,37,41,50,49,59,1
18.10.2025,2025,rom,169,Corona Brasov,Municipal Galati,92,78,22,16,28,19,23,20,19,23,38,47,43,42,1
18.10.2025,2025,rom,161,Voluntari,Petrolul Ploiesti,98,63,28,16,24,12,24,19,22,16,44,36,43,38,1
21.10.2025,2025,rom,158,BC Timisoara,x,69,81,15,20,15,17,19,20,20,24,35,32,39,44,1
21.10.2025,2025,rom,156,SCM Craiova,x,89,76,25,23,17,21,25,13,22,19,48,38,38,41,1
20.10.2025,2025,rom,159,Valcea,x,59,69,10,29,11,16,17,14,21,10,39,27,31,31,-1
19.10.2025,2025,rom,155,BC Steaua Bucuresti,x,86,69,26,12,23,21,17,23,20,13,38,44,40,33,-1
19.10.2025,2025,rom,152,CSM Oradea,x,67,76,14,22,20,13,21,18,12,23,36,33,39,35,-1
19.10.2025,2025,rom,168,Cluj-Napoca,x,85,114,15,26,25,25,23,26,22,37,41,50,49,59,1
18.10.2025,2025,rom,169,Municipal Galati,x,92,78,22,16,28,19,23,20,19,23,38,47,43,42,1
18.10.2025,2025,rom,161,Petrolul Ploiesti,x,98,63,28,16,24,12,24,19,22,16,44,36,43,38,1
19.10.2025,2025,swit,156,Neuchatel,Fribourg Olympic,69,93,15,15,21,28,14,26,19,24,30,49,40,43,1
19.10.2025,2025,swit,160,SAM Massagno,Geneva Lions,78,87,20,15,20,22,17,20,21,30,35,42,37,51,1
19.10.2025,2025,swit,160,Lugano Tigers,Lausanne Basket,77,84,16,17,17,25,25,20,19,22,33,42,45,41,1
19.10.2025,2025,swit,156,Neuchatel,Fribourg Olympic,69,93,15,15,21,28,14,26,19,24,30,49,40,43,1
19.10.2025,2025,swit,160,SAM Massagno,Geneva Lions,78,87,20,15,20,22,17,20,21,30,35,42,37,51,1
19.10.2025,2025,swit,160,Lugano Tigers,Lausanne Basket,77,84,16,17,17,25,25,20,19,22,33,42,45,41,1
19.10.2025,2025,swit,156,Fribourg Olympic,x,69,93,15,15,21,28,14,26,19,24,30,49,40,43,1
19.10.2025,2025,swit,160,Geneva Lions,x,78,87,20,15,20,22,17,20,21,30,35,42,37,51,1
19.10.2025,2025,swit,160,Lausanne Basket,x,77,84,16,17,17,25,25,20,19,22,33,42,45,41,1
19.10.2025,2025,swit,156,Fribourg Olympic,x,69,93,15,15,21,28,14,26,19,24,30,49,40,43,1
19.10.2025,2025,swit,160,Geneva Lions,x,78,87,20,15,20,22,17,20,21,30,35,42,37,51,1
19.10.2025,2025,swit,160,Lausanne Basket,x,77,84,16,17,17,25,25,20,19,22,33,42,45,41,1
21.10.2025,2025,tur,176,Anadolu Efes,Darussafaka,95,72,23,19,21,23,28,20,23,10,42,44,48,33,-1
20.10.2025,2025,tur,170,Fenerbahce,Bursaspor,95,78,25,19,18,15,27,16,25,28,44,33,43,53,1
20.10.2025,2025,tur,175,Bahcesehir Kol.,Galatasaray,80,86,20,18,17,21,26,26,17,21,38,38,52,38,1
20.10.2025,2025,tur,172,Tofas,Buyukcekmece,93,86,24,21,19,27,18,21,32,17,45,46,39,49,1
20.10.2025,2025,tur,172,Karsiyaka,Mersin SK,107,81,29,22,26,26,29,15,23,18,51,52,44,41,-1
19.10.2025,2025,tur,164,Manisa,Petkim Spor,67,74,17,6,11,22,18,22,21,24,23,33,40,45,1
19.10.2025,2025,tur,157,Turk Telekom,Yalovaspor,82,64,15,13,32,15,16,21,19,15,28,47,37,34,-1
19.10.2025,2025,tur,172,Merkezefendi,Besiktas,72,86,15,12,16,22,17,24,24,28,27,38,41,52,1
14.10.2025,2025,tur,170,Darussafaka,Manisa,94,86,34,24,22,16,22,23,16,23,58,38,45,39,-1
21.10.2025,2025,tur b,156,Kapakli Spor,Ankara Kolejliler,88,87,21,19,19,22,27,28,21,18,40,41,55,39,1
20.10.2025,2025,tur b,158,Balikesir,Cayirova,92,107,16,12,22,24,19,22,31,30,28,46,41,61,1
20.10.2025,2025,tur b,154,Trabzonspor,iLab Basketbol,89,77,15,16,23,11,25,21,26,29,31,34,46,55,1
20.10.2025,2025,tur b,157,Çağdaş Bodrum Spor,Istanbul Anka Spor,95,73,19,19,34,16,23,24,19,14,38,50,47,33,1
19.10.2025,2025,tur b,154,Harem Spor,Gaziantep,85,69,20,13,24,17,18,25,23,14,33,41,43,37,1
19.10.2025,2025,tur b,160,MKE Ankaragucu,Bordo Sportif,91,78,23,18,23,23,20,22,25,15,41,46,42,40,1
19.10.2025,2025,tur b,157,Fenerbahce 2,Esenler Erokspor,63,78,16,18,18,21,12,22,17,17,34,39,34,34,-1
19.10.2025,2025,tur b,151,CO Basket,OGM Ormanspor,73,88,15,22,18,24,20,15,20,27,37,42,35,47,1
18.10.2025,2025,tur b,157,Konya BBSK,Final Spor,71,79,17,17,24,21,14,18,16,23,34,45,32,39,-1
14.10.2025,2025,tur b,160,OGM Ormanspor,Gaziantep,79,70,26,13,22,31,16,14,15,12,39,53,30,27,-1
21.10.2025,2025,tur,176,Darussafaka,x,95,72,23,19,21,23,28,20,23,10,42,44,48,33,-1
20.10.2025,2025,tur,170,Bursaspor,x,95,78,25,19,18,15,27,16,25,28,44,33,43,53,1
20.10.2025,2025,tur,175,Galatasaray,x,80,86,20,18,17,21,26,26,17,21,38,38,52,38,1
20.10.2025,2025,tur,172,Buyukcekmece,x,93,86,24,21,19,27,18,21,32,17,45,46,39,49,1
20.10.2025,2025,tur,172,Mersin SK,x,107,81,29,22,26,26,29,15,23,18,51,52,44,41,-1
19.10.2025,2025,tur,164,Petkim Spor,x,67,74,17,6,11,22,18,22,21,24,23,33,40,45,1
19.10.2025,2025,tur,157,Yalovaspor,x,82,64,15,13,32,15,16,21,19,15,28,47,37,34,-1
19.10.2025,2025,tur,172,Besiktas,x,72,86,15,12,16,22,17,24,24,28,27,38,41,52,1
14.10.2025,2025,tur,170,Manisa,x,94,86,34,24,22,16,22,23,16,23,58,38,45,39,-1
21.10.2025,2025,tur b,156,Ankara Kolejliler,x,88,87,21,19,19,22,27,28,21,18,40,41,55,39,1
20.10.2025,2025,tur b,158,Cayirova,x,92,107,16,12,22,24,19,22,31,30,28,46,41,61,1
20.10.2025,2025,tur b,154,iLab Basketbol,x,89,77,15,16,23,11,25,21,26,29,31,34,46,55,1
20.10.2025,2025,tur b,157,Istanbul Anka Spor,x,95,73,19,19,34,16,23,24,19,14,38,50,47,33,1
19.10.2025,2025,tur b,154,Gaziantep,x,85,69,20,13,24,17,18,25,23,14,33,41,43,37,1
19.10.2025,2025,tur b,160,Bordo Sportif,x,91,78,23,18,23,23,20,22,25,15,41,46,42,40,1
19.10.2025,2025,tur b,157,Esenler Erokspor,x,63,78,16,18,18,21,12,22,17,17,34,39,34,34,-1
19.10.2025,2025,tur b,151,OGM Ormanspor,x,73,88,15,22,18,24,20,15,20,27,37,42,35,47,1
18.10.2025,2025,tur b,157,Final Spor,x,71,79,17,17,24,21,14,18,16,23,34,45,32,39,-1
14.10.2025,2025,tur b,160,Gaziantep,x,79,70,26,13,22,31,16,14,15,12,39,53,30,27,-1
20.10.2025,2025,ukr,148,Stariy Lutsk,Cherkaski Mavpy,68,71,9,19,15,18,23,16,21,18,28,33,39,39,1
20.10.2025,2025,ukr,144,Rivne,Kryvbas,69,60,22,7,16,9,18,27,13,17,29,25,45,30,1
19.10.2025,2025,ukr,143,Stariy Lutsk,Kryvbas,74,79,25,19,11,17,15,20,23,23,44,28,35,46,1
19.10.2025,2025,ukr,150,Rivne,Cherkaski Mavpy,68,72,26,16,13,22,16,17,13,17,42,35,33,30,-1
19.10.2025,2025,ukr,142,Goverla,BK Zaporozhye,58,67,16,14,15,17,13,21,14,15,30,32,34,29,-1
18.10.2025,2025,ukr,153,Kyiv Basket,BK Zaporozhye,72,71,19,18,18,17,20,19,15,17,37,35,39,32,-1
20.10.2025,2025,ukr,148,Cherkaski Mavpy,x,68,71,9,19,15,18,23,16,21,18,28,33,39,39,1
20.10.2025,2025,ukr,144,Kryvbas,x,69,60,22,7,16,9,18,27,13,17,29,25,45,30,1
19.10.2025,2025,ukr,143,Kryvbas,x,74,79,25,19,11,17,15,20,23,23,44,28,35,46,1
19.10.2025,2025,ukr,150,Cherkaski Mavpy,x,68,72,26,16,13,22,16,17,13,17,42,35,33,30,-1
19.10.2025,2025,ukr,142,BK Zaporozhye,x,58,67,16,14,15,17,13,21,14,15,30,32,34,29,-1
18.10.2025,2025,ukr,153,BK Zaporozhye,x,72,71,19,18,18,17,20,19,15,17,37,35,39,32,-1
21.10.2025,2025,vtb,163,Uralmash Ekaterinburg,Zenit Petersburg,72,78,16,22,18,11,19,17,19,28,38,29,36,47,1
20.10.2025,2025,vtb,164,Lokomotiv Kuban,Unics Kazan,78,71,20,13,20,16,18,17,20,25,33,36,35,45,-1
20.10.2025,2025,vtb,153,Nizhny Novgorod,MBA Moscow,71,57,12,13,19,22,19,10,21,12,25,41,29,33,-1
20.10.2025,2025,vtb,152,Parma Perm,CSKA Moscow,82,95,21,22,11,26,23,21,27,26,43,37,44,53,1
19.10.2025,2025,vtb,149,Saratov,Enisey,64,52,17,17,17,9,20,15,10,11,34,26,35,21,-1
19.10.2025,2025,vtb,155,Samara,Astana,91,57,21,18,20,14,27,14,23,11,39,34,41,34,-1
21.10.2025,2025,vtb,163,Zenit Petersburg,x,72,78,16,22,18,11,19,17,19,28,38,29,36,47,1
20.10.2025,2025,vtb,164,Unics Kazan,x,78,71,20,13,20,16,18,17,20,25,33,36,35,45,-1
20.10.2025,2025,vtb,153,MBA Moscow,x,71,57,12,13,19,22,19,10,21,12,25,41,29,33,-1
20.10.2025,2025,vtb,152,CSKA Moscow,x,82,95,21,22,11,26,23,21,27,26,43,37,44,53,1
19.10.2025,2025,vtb,149,Enisey,x,64,52,17,17,17,9,20,15,10,11,34,26,35,21,-1
19.10.2025,2025,vtb,155,Astana,x,91,57,21,18,20,14,27,14,23,11,39,34,41,34,-1
25.10.2025,2025,kore,163,KCC Egis,Mobis Phoebus,76,96,20,26,13,24,25,25,18,21,46,37,50,39,1
25.10.2025,2025,kore,157,Suwon KT,Seoul Knights,77,75,26,20,20,23,22,21,9,11,46,43,43,20,-1
24.10.2025,2025,kore,159,LG Sakers,Anyang JungKwanJang,82,75,19,26,26,17,14,16,23,16,45,43,30,39,-1
24.10.2025,2025,kore,160,Wonju DB,KoGas,62,92,11,25,18,16,18,29,15,22,36,34,47,37,1
23.10.2025,2025,kore,166,KCC Egis,Goyang Sono,69,79,24,21,18,24,12,14,15,20,45,42,26,35,-1
22.10.2025,2025,kore,167,Seoul Knights,Wonju DB,77,72,17,18,17,24,20,16,23,14,35,41,36,37,-1
25.10.2025,2025,kore,163,Mobis Phoebus,x,76,96,20,26,13,24,25,25,18,21,46,37,50,39,1
25.10.2025,2025,kore,157,Seoul Knights,x,77,75,26,20,20,23,22,21,9,11,46,43,43,20,-1
24.10.2025,2025,kore,159,Anyang JungKwanJang,x,82,75,19,26,26,17,14,16,23,16,45,43,30,39,-1
24.10.2025,2025,kore,160,KoGas,x,62,92,11,25,18,16,18,29,15,22,36,34,47,37,1
23.10.2025,2025,kore,166,Goyang Sono,x,69,79,24,21,18,24,12,14,15,20,45,42,26,35,-1
22.10.2025,2025,kore,167,Wonju DB,x,77,72,17,18,17,24,20,16,23,14,35,41,36,37,-1
25.10.2025,2025,avst,177,Perth,Sydney,87,84,21,21,20,23,24,16,22,24,42,43,40,46,-1
25.10.2025,2025,avst,177,Adelaide,Cairns Taipans,99,93,21,27,22,32,22,14,23,15,48,54,36,38,-1
24.10.2025,2025,avst,186,Illawarra Hawks,Melbourne United,87,92,21,18,16,22,21,19,29,33,39,38,40,62,1
24.10.2025,2025,avst,174,New Zealand Breakers,South East Melbourne,62,88,17,27,18,20,16,18,11,23,44,38,34,34,-1
25.10.2025,2025,avst,177,Sydney,x,87,84,21,21,20,23,24,16,22,24,42,43,40,46,-1
25.10.2025,2025,avst,177,Cairns Taipans,x,99,93,21,27,22,32,22,14,23,15,48,54,36,38,-1
24.10.2025,2025,avst,186,Melbourne United,x,87,92,21,18,16,22,21,19,29,33,39,38,40,62,1
24.10.2025,2025,avst,174,South East Melbourne,x,62,88,17,27,18,20,16,18,11,23,44,38,34,34,-1
25.10.2025,2025,bnxt,162,Kortrijk,Limburg,92,84,26,14,27,26,16,18,23,26,40,53,34,49,1
24.10.2025,2025,bnxt,149,Leuven Bears,Den Helder,91,67,23,13,18,21,21,22,29,11,36,39,43,40,1
25.10.2025,2025,bnxt,162,Limburg,x,92,84,26,14,27,26,16,18,23,26,40,53,34,49,1
24.10.2025,2025,bnxt,149,Den Helder,x,91,67,23,13,18,21,21,22,29,11,36,39,43,40,1
24.10.2025,2025,lat nkl,170,Rytas 2,Silute,102,66,29,19,30,18,22,17,21,12,48,48,39,33,-1
24.10.2025,2025,lat nkl,160,Ukmerges Stekas,Telsiai,94,92,10,16,19,24,23,23,25,14,26,43,46,39,1
24.10.2025,2025,lat nkl,168,Delikatesas Joniskis,Vilkaviskis,80,88,19,20,9,21,16,23,36,24,39,30,39,60,1
24.10.2025,2025,lat nkl,160,Neptunas 2,Jurbarkas,73,77,20,21,18,18,12,15,23,23,41,36,27,46,-1
24.10.2025,2025,lat nkl,161,Suduva-Mantinga,Alytaus Alytus,101,71,26,22,24,24,22,10,29,15,48,48,32,44,-1
24.10.2025,2025,lat nkl,161,Kretinga,x,66,48,16,15,13,10,17,12,20,11,31,23,29,31,-1
24.10.2025,2025,lat nkl,160,Telsiai,x,94,92,10,16,19,24,23,23,25,14,26,43,46,39,1
24.10.2025,2025,lat nkl,168,Vilkaviskis,x,80,88,19,20,9,21,16,23,36,24,39,30,39,60,1
24.10.2025,2025,lat nkl,160,Jurbarkas,x,73,77,20,21,18,18,12,15,23,23,41,36,27,46,-1
24.10.2025,2025,lat nkl,158,Plunges Olimpas,x,80,72,18,13,25,19,21,25,16,15,31,44,46,31,-1
24.10.2025,2025,lat nkl,161,Alytaus Alytus,x,101,71,26,22,24,24,22,10,29,15,48,48,32,44,-1
25.10.2025,2025,fin,165,BC Nokia,Helsinki Seagulls,77,75,20,20,15,33,18,14,24,8,40,48,32,32,-1
23.10.2025,2025,fin,169,Kobrat,UU-Korihait Uusikaupunki,87,70,27,20,25,16,21,21,14,13,47,41,42,27,-1
22.10.2025,2025,fin,159,Bisons Loimaa,BC Nokia,77,64,14,17,25,19,14,7,24,21,31,44,21,45,-1
22.10.2025,2025,fin,166,Helsinki Seagulls,Pyrinto Tampere,95,91,23,26,20,19,28,18,24,28,49,39,46,52,1
22.10.2025,2025,fin,169,Honka,Kataja,92,95,14,19,34,24,22,24,17,20,33,58,46,37,-1
22.10.2025,2025,fin,171,Kouvot Kouvola,Salon Vilpas,79,66,19,15,17,13,25,18,18,20,34,30,43,38,-1
22.10.2025,2025,fin,164,KTP Kotka Basket,Karhu Basket,85,86,26,19,23,29,24,20,12,18,45,52,44,30,-1
25.10.2025,2025,fin,165,Helsinki Seagulls,x,77,75,20,20,15,33,18,14,24,8,40,48,32,32,-1
23.10.2025,2025,fin,169,UU-Korihait Uusikaupunki,x,87,70,27,20,25,16,21,21,14,13,47,41,42,27,-1
22.10.2025,2025,fin,159,BC Nokia,x,77,64,14,17,25,19,14,7,24,21,31,44,21,45,-1
22.10.2025,2025,fin,166,Pyrinto Tampere,x,95,91,23,26,20,19,28,18,24,28,49,39,46,52,1
22.10.2025,2025,fin,169,Kataja,x,92,95,14,19,34,24,22,24,17,20,33,58,46,37,-1
22.10.2025,2025,fin,171,Salon Vilpas,x,79,66,19,15,17,13,25,18,18,20,34,30,43,38,-1
22.10.2025,2025,fin,164,Karhu Basket,x,85,86,26,19,23,29,24,20,12,18,45,52,44,30,-1
25.10.2025,2025,pol,161,Slask Wroclaw,Szczecin,66,67,20,14,18,14,19,21,9,18,34,32,40,27,-1
25.10.2025,2025,pol,162,Gornik Walbrzych,Zielona Gora,62,56,14,13,14,12,20,17,14,14,27,26,37,28,-1
25.10.2025,2025,pol,174,GTK Gliwice,Lublin,110,105,30,22,18,28,23,27,28,22,52,46,50,50,1
25.10.2025,2025,pol,161,Szczecin,x,66,67,20,14,18,14,19,21,9,18,34,32,40,27,-1
25.10.2025,2025,pol,162,Zielona Gora,x,62,56,14,13,14,12,20,17,14,14,27,26,37,28,-1
25.10.2025,2025,pol,174,Lublin,x,110,105,30,22,18,28,23,27,28,22,52,46,50,50,1
25.10.2025,2025,rom,151,BC Steaua Bucuresti,Dinamo Bucharest,85,80,21,24,20,20,20,20,24,16,45,40,40,40,1
24.10.2025,2025,rom,154,BC Timisoara,Corona Brasov,62,99,16,31,13,23,14,26,19,19,47,36,40,38,1
21.10.2025,2025,rom,158,CSU Sibiu,BC Timisoara,69,81,15,20,15,17,19,20,20,24,35,32,39,44,1
21.10.2025,2025,rom,157,CSM Targu Mures,SCM Craiova,89,76,25,23,17,21,25,13,22,19,48,38,38,41,1
20.10.2025,2025,rom,159,Dinamo Bucharest,Valcea,59,69,10,29,11,16,17,14,21,10,39,27,31,31,-1
25.10.2025,2025,rom,151,Dinamo Bucharest,x,85,80,21,24,20,20,20,20,24,16,45,40,40,40,1
24.10.2025,2025,rom,154,Corona Brasov,x,62,99,16,31,13,23,14,26,19,19,47,36,40,38,1
21.10.2025,2025,rom,158,BC Timisoara,x,69,81,15,20,15,17,19,20,20,24,35,32,39,44,1
21.10.2025,2025,rom,157,SCM Craiova,x,89,76,25,23,17,21,25,13,22,19,48,38,38,41,1
20.10.2025,2025,rom,159,Valcea,x,59,69,10,29,11,16,17,14,21,10,39,27,31,31,-1
27.10.2025,2025,kore,162,Wonju DB,KCC Egis,70,77,21,13,18,27,10,18,21,19,34,45,28,40,-1
27.10.2025,2025,kore,159,Seoul Thunders,Seoul Knights,73,76,24,15,17,17,20,20,12,24,39,34,40,36,-1
27.10.2025,2025,kore,162,Suwon KT,Mobis Phoebus,89,91,27,18,23,25,10,20,17,14,45,48,30,31,-1
26.10.2025,2025,kore,163,Anyang JungKwanJang,Wonju DB,68,60,21,17,18,21,16,10,13,12,38,39,26,25,-1
26.10.2025,2025,kore,156,Goyang Sono,LG Sakers,82,77,19,20,20,21,20,22,23,14,39,41,42,37,1
26.10.2025,2025,kore,158,KoGas,Seoul Thunders,76,70,15,23,30,21,12,6,19,20,38,51,18,39,-1
27.10.2025,2025,kore,162,KCC Egis,x,70,77,21,13,18,27,10,18,21,19,34,45,28,40,-1
27.10.2025,2025,kore,159,Seoul Knights,x,73,76,24,15,17,17,20,20,12,24,39,34,40,36,-1
27.10.2025,2025,kore,162,Mobis Phoebus,x,89,91,27,18,23,25,10,20,17,14,45,48,30,31,-1
26.10.2025,2025,kore,163,Wonju DB,x,68,60,21,17,18,21,16,10,13,12,38,39,26,25,-1
26.10.2025,2025,kore,156,LG Sakers,x,82,77,19,20,20,21,20,22,23,14,39,41,42,37,1
26.10.2025,2025,kore,158,Seoul Thunders,x,76,70,15,23,30,21,12,6,19,20,38,51,18,39,-1
24.10.2025,2025,aba 2,153,Sutjeska,Vojvodina Novi Sad,96,79,30,23,12,16,28,13,26,27,53,28,41,53,1
23.10.2025,2025,aba 2,144,MZT Skopje,Helios Domzale,70,72,17,17,13,17,25,15,15,23,34,30,40,38,1
23.10.2025,2025,aba 2,156,Rabotnicki,KK Bosna,74,99,16,25,16,29,19,27,23,18,41,45,46,41,1
22.10.2025,2025,aba 2,150,Tivat,Cedevita Junior,76,97,19,20,19,20,16,33,22,24,39,39,49,46,1
24.10.2025,2025,aba 2,153,Vojvodina Novi Sad,x,96,79,30,23,12,16,28,13,26,27,53,28,41,53,1
23.10.2025,2025,aba 2,144,Helios Domzale,x,70,72,17,17,13,17,25,15,15,23,34,30,40,38,1
23.10.2025,2025,aba 2,156,KK Bosna,x,74,99,16,25,16,29,19,27,23,18,41,45,46,41,1
22.10.2025,2025,aba 2,150,Cedevita Junior,x,76,97,19,20,19,20,16,33,22,24,39,39,49,46,1
17.10.2025,2025,aba 2,158,Ilirija,x,61,95,22,25,11,26,15,23,13,21,47,37,38,34,-1
27.10.2025,2025,aba,167,Subotica,Mornar Bar,85,64,27,14,20,21,15,13,23,16,41,41,28,39,-1
27.10.2025,2025,aba,161,Cedevita Olimpija,Buducnost,71,91,26,19,15,27,13,24,17,21,45,42,37,38,-1
27.10.2025,2025,aba,161,Borac,Split,61,73,15,15,19,17,15,21,12,20,30,36,36,32,-1
27.10.2025,2025,aba,162,Mega Basket,Igokea,64,73,11,15,19,24,19,18,15,16,26,43,37,31,-1
26.10.2025,2025,aba,164,Cibona,Dubai,74,102,17,35,19,23,16,23,22,21,52,42,39,43,-1
26.10.2025,2025,aba,155,Zadar,Crvena zvezda,77,84,31,14,13,27,16,22,17,21,45,40,38,38,-1
26.10.2025,2025,aba,164,Partizan,KK Krka Novo mesto,96,63,18,16,23,12,29,20,26,15,34,35,49,41,1
21.10.2025,2025,aba,158,Buducnost,Crvena zvezda,73,75,17,16,20,17,21,19,15,23,33,37,40,38,-1
27.10.2025,2025,aba,167,Mornar Bar,x,85,64,27,14,20,21,15,13,23,16,41,41,28,39,-1
27.10.2025,2025,aba,161,Buducnost,x,71,91,26,19,15,27,13,24,17,21,45,42,37,38,-1
27.10.2025,2025,aba,161,Split,x,61,73,15,15,19,17,15,21,12,20,30,36,36,32,-1
27.10.2025,2025,aba,162,Igokea,x,64,73,11,15,19,24,19,18,15,16,26,43,37,31,-1
26.10.2025,2025,aba,164,Dubai,x,74,102,17,35,19,23,16,23,22,21,52,42,39,43,-1
26.10.2025,2025,aba,155,Crvena zvezda,x,77,84,31,14,13,27,16,22,17,21,45,40,38,38,-1
26.10.2025,2025,aba,164,KK Krka Novo mesto,x,96,63,18,16,23,12,29,20,26,15,34,35,49,41,1
21.10.2025,2025,aba,158,Crvena zvezda,x,73,75,17,16,20,17,21,19,15,23,33,37,40,38,-1
27.10.2025,2025,aus,155,Klosterneuburg Dukes,Traiskirchen Lions,53,59,14,10,15,14,9,17,15,18,24,29,26,33,-1
27.10.2025,2025,aus,156,Furstenfeld,Graz UBSC,59,88,14,29,10,22,15,9,20,28,43,32,24,48,-1
26.10.2025,2025,aus,161,Kapfenberg Bulls,Swans Gmunden,84,85,18,25,25,20,20,16,21,24,43,45,36,45,1
26.10.2025,2025,aus,161,BBC Nord,St. Polten,90,76,22,19,31,21,13,18,24,18,41,52,31,42,-1
26.10.2025,2025,aus,162,Wels,Vienna Basket,93,89,30,18,28,31,13,18,22,22,48,59,31,44,-1
27.10.2025,2025,aus,155,Traiskirchen Lions,x,53,59,14,10,15,14,9,17,15,18,24,29,26,33,-1
27.10.2025,2025,aus,156,Graz UBSC,x,59,88,14,29,10,22,15,9,20,28,43,32,24,48,-1
26.10.2025,2025,aus,161,Swans Gmunden,x,84,85,18,25,25,20,20,16,21,24,43,45,36,45,1
26.10.2025,2025,aus,161,St. Polten,x,90,76,22,19,31,21,13,18,24,18,41,52,31,42,-1
26.10.2025,2025,aus,162,Vienna Basket,x,93,89,30,18,28,31,13,18,22,22,48,59,31,44,-1
27.10.2025,2025,avst,179,Melbourne United,Cairns Taipans,106,63,23,12,31,18,30,19,22,14,35,49,49,36,-1
27.10.2025,2025,avst,172,Sydney,New Zealand Breakers,89,93,25,18,20,31,24,23,20,21,43,51,47,41,1
26.10.2025,2025,avst,168,Brisbane Bullets,Tasmania JackJumpers,79,87,9,20,23,22,30,17,17,28,29,45,47,45,1
26.10.2025,2025,avst,181,South East Melbourne,Illawarra Hawks,82,88,19,15,20,30,26,29,17,14,34,50,55,31,-1
27.10.2025,2025,avst,179,Cairns Taipans,x,106,63,23,12,31,18,30,19,22,14,35,49,49,36,-1
27.10.2025,2025,avst,172,New Zealand Breakers,x,89,93,25,18,20,31,24,23,20,21,43,51,47,41,1
26.10.2025,2025,avst,168,Tasmania JackJumpers,x,79,87,9,20,23,22,30,17,17,28,29,45,47,45,1
26.10.2025,2025,avst,181,Illawarra Hawks,x,82,88,19,15,20,30,26,29,17,14,34,50,55,31,-1
27.10.2025,2025,bnxt,160,LWD Basket,Mechelen,89,85,26,28,22,24,29,20,12,13,54,46,49,25,-1
27.10.2025,2025,bnxt,157,QSTA Utd,Belfius Mons,111,113,23,27,30,25,25,24,22,24,50,55,49,46,1
27.10.2025,2025,bnxt,158,Circus Brussels,Feyenoord,73,61,19,14,9,14,25,8,20,25,33,23,33,45,-1
27.10.2025,2025,bnxt,160,Zwolle,BAL Weert,104,77,22,26,24,16,30,19,28,16,48,40,49,44,1
26.10.2025,2025,bnxt,161,Okapi Aalst,Den Bosch,93,61,25,17,17,11,31,13,20,20,42,28,44,40,1
26.10.2025,2025,bnxt,158,Oostende,Donar Groningen,95,68,24,17,16,16,31,12,24,23,41,32,43,47,1
26.10.2025,2025,bnxt,153,Leiden,Spirou Charleroi,50,73,12,15,17,18,12,18,9,22,27,35,30,31,-1
27.10.2025,2025,bnxt,160,Mechelen,x,89,85,26,28,22,24,29,20,12,13,54,46,49,25,-1
27.10.2025,2025,bnxt,157,Belfius Mons,x,111,113,23,27,30,25,25,24,22,24,50,55,49,46,1
27.10.2025,2025,bnxt,158,Feyenoord,x,73,61,19,14,9,14,25,8,20,25,33,23,33,45,-1
27.10.2025,2025,bnxt,160,BAL Weert,x,104,77,22,26,24,16,30,19,28,16,48,40,49,44,1
26.10.2025,2025,bnxt,161,Den Bosch,x,93,61,25,17,17,11,31,13,20,20,42,28,44,40,1
26.10.2025,2025,bnxt,158,Donar Groningen,x,95,68,24,17,16,16,31,12,24,23,41,32,43,47,1
26.10.2025,2025,bnxt,153,Spirou Charleroi,x,50,73,12,15,17,18,12,18,9,22,27,35,30,31,-1
27.10.2025,2025,bos,,HKK Mostar,Spars Ilidza,83,84,24,27,19,26,17,18,23,13,51,45,35,36,
27.10.2025,2025,bos,165,KK Bosna,Slavija,94,81,21,23,27,16,21,27,25,15,44,43,48,40,1
26.10.2025,2025,bos,157,Posusje,Leotar Trebinje,55,82,9,22,17,21,11,15,18,24,31,38,26,42,-1
26.10.2025,2025,bos,164,Radnicki Gorazde,Mrkonjic Grad,86,77,26,20,20,23,25,12,15,22,46,43,37,37,-1
26.10.2025,2025,bos,160,Sloboda,Promo,91,80,26,19,28,21,15,17,22,23,45,49,32,45,-1
26.10.2025,2025,bos,154,Orlovik,Borac Banja Luka,77,96,14,27,24,21,23,24,16,24,41,45,47,40,1
25.10.2025,2025,bos,158,Siroki Brijeg,Jahorina,90,64,28,14,24,17,16,17,22,16,42,41,33,38,-1
27.10.2025,2025,bos,,Spars Ilidza,x,83,84,24,27,19,26,17,18,23,13,51,45,35,36,
27.10.2025,2025,bos,165,Slavija,x,94,81,21,23,27,16,21,27,25,15,44,43,48,40,1
26.10.2025,2025,bos,157,Leotar Trebinje,x,55,82,9,22,17,21,11,15,18,24,31,38,26,42,-1
26.10.2025,2025,bos,164,Mrkonjic Grad,x,86,77,26,20,20,23,25,12,15,22,46,43,37,37,-1
26.10.2025,2025,bos,160,Promo,x,91,80,26,19,28,21,15,17,22,23,45,49,32,45,-1
26.10.2025,2025,bos,154,Borac Banja Luka,x,77,96,14,27,24,21,23,24,16,24,41,45,47,40,1
25.10.2025,2025,bos,158,Jahorina,x,90,64,28,14,24,17,16,17,22,16,42,41,33,38,-1
27.10.2025,2025,bul,163,Balkan,Academic Plovdiv,104,83,23,20,31,22,25,27,25,14,43,53,52,39,1
26.10.2025,2025,bul,170,Beroe,Rilski Sportist,66,111,14,33,20,18,12,39,20,21,47,38,51,41,1
25.10.2025,2025,bul,170,Cherno More,Shumen,89,81,15,19,25,18,24,19,25,25,34,43,43,50,1
27.10.2025,2025,bul,163,Academic Plovdiv,x,104,83,23,20,31,22,25,27,25,14,43,53,52,39,1
26.10.2025,2025,bul,170,Rilski Sportist,x,66,111,14,33,20,18,12,39,20,21,47,38,51,41,1
25.10.2025,2025,bul,170,Shumen,x,89,81,15,19,25,18,24,19,25,25,34,43,43,50,1
27.10.2025,2025,cek,172,Usti n. Labem,Srsni Pisek,61,72,15,19,19,14,19,17,8,22,34,33,36,30,-1
27.10.2025,2025,cek,163,Brno,NH Ostrava,68,84,13,24,16,19,18,16,21,25,37,35,34,46,-1
26.10.2025,2025,cek,167,Olomoucko,Jindrichuv Hradec,93,81,26,21,26,22,22,10,19,28,47,48,32,47,-1
26.10.2025,2025,cek,163,Opava,Slavia Prague,80,74,27,22,19,14,14,15,20,23,49,33,29,43,-1
26.10.2025,2025,cek,166,Pardubice,Decin,74,82,13,26,19,17,19,16,23,23,39,36,35,46,-1
26.10.2025,2025,cek,168,Nymburk,USK Prague,91,77,20,18,23,19,27,23,21,17,38,42,50,38,1
27.10.2025,2025,cek,172,Srsni Pisek,x,61,72,15,19,19,14,19,17,8,22,34,33,36,30,-1
27.10.2025,2025,cek,163,NH Ostrava,x,68,84,13,24,16,19,18,16,21,25,37,35,34,46,-1
26.10.2025,2025,cek,167,Jindrichuv Hradec,x,93,81,26,21,26,22,22,10,19,28,47,48,32,47,-1
26.10.2025,2025,cek,163,Slavia Prague,x,80,74,27,22,19,14,14,15,20,23,49,33,29,43,-1
26.10.2025,2025,cek,166,Decin,x,74,82,13,26,19,17,19,16,23,23,39,36,35,46,-1
26.10.2025,2025,cek,168,USK Prague,x,91,77,20,18,23,19,27,23,21,17,38,42,50,38,1
27.10.2025,2025,cro,154,Alkar,Osijek,84,74,24,25,29,15,10,15,21,19,49,44,25,40,-1
26.10.2025,2025,cro,154,GKK Sibenka,Dubrovnik,62,74,15,18,19,22,14,15,14,19,33,41,29,33,-1
26.10.2025,2025,cro,161,Zabok,Dubrava,78,71,14,19,26,15,13,21,25,16,33,41,34,41,-1
26.10.2025,2025,cro,162,Cedevita Junior,Kvarner,74,83,18,23,8,20,23,23,25,17,41,28,46,42,1
24.10.2025,2025,cro,165,Dinamo Zagreb,Split,111,121,27,28,25,18,19,24,21,22,55,43,43,43,1
24.10.2025,2025,cro,154,Zadar,Cibona,78,68,20,14,19,17,13,25,26,12,34,36,38,38,-1
21.10.2025,2025,cro,164,Split,GKK Sibenka,97,62,22,15,30,22,19,18,26,7,37,52,37,33,-1
27.10.2025,2025,cro,154,Osijek,x,84,74,24,25,29,15,10,15,21,19,49,44,25,40,-1
26.10.2025,2025,cro,154,Dubrovnik,x,62,74,15,18,19,22,14,15,14,19,33,41,29,33,-1
26.10.2025,2025,cro,161,Dubrava,x,78,71,14,19,26,15,13,21,25,16,33,41,34,41,-1
26.10.2025,2025,cro,162,Kvarner,x,74,83,18,23,8,20,23,23,25,17,41,28,46,42,1
24.10.2025,2025,cro,165,Split,x,111,121,27,28,25,18,19,24,21,22,55,43,43,43,1
24.10.2025,2025,cro,154,Cibona,x,78,68,20,14,19,17,13,25,26,12,34,36,38,38,-1
21.10.2025,2025,cro,164,GKK Sibenka,x,97,62,22,15,30,22,19,18,26,7,37,52,37,33,-1
27.10.2025,2025,fin,167,Pyrinto Tampere,Kobrat,84,72,21,15,21,24,20,19,22,14,36,45,39,36,-1
26.10.2025,2025,fin,163,Karhu Basket,Kouvot Kouvola,95,70,21,29,21,20,22,17,31,4,50,41,39,35,-1
26.10.2025,2025,fin,161,Salon Vilpas,Bisons Loimaa,77,73,23,15,11,18,21,17,22,23,38,29,38,45,1
26.10.2025,2025,fin,170,Kataja,KTP Kotka Basket,107,94,29,32,21,24,24,16,33,22,61,45,40,55,1
26.10.2025,2025,fin,166,UU-Korihait Uusikaupunki,Honka,79,87,18,30,21,15,18,24,22,18,48,36,42,40,-1
27.10.2025,2025,fin,167,Kobrat,x,84,72,21,15,21,24,20,19,22,14,36,45,39,36,-1
26.10.2025,2025,fin,163,Kouvot Kouvola,x,95,70,21,29,21,20,22,17,31,4,50,41,39,35,-1
26.10.2025,2025,fin,161,Bisons Loimaa,x,77,73,23,15,11,18,21,17,22,23,38,29,38,45,1
26.10.2025,2025,fin,170,KTP Kotka Basket,x,107,94,29,32,21,24,24,16,33,22,61,45,40,55,1
26.10.2025,2025,fin,166,Honka,x,79,87,18,30,21,15,18,24,22,18,48,36,42,40,-1
23.10.2025,2025,eurocup,171,Trento,Hapoel Tel-Aviv,79,73,26,18,15,20,16,20,22,15,44,35,36,37,-1
23.10.2025,2025,eurocup,158,Buducnost,Bahcesehir Kol.,75,92,20,26,29,19,7,25,19,22,46,48,32,41,-1
23.10.2025,2025,eurocup,155,Aris,Cedevita Olimpija,75,82,24,23,24,14,13,17,14,28,47,38,30,42,-1
23.10.2025,2025,eurocup,167,Hapoel Jerusalem,Cluj-Napoca,73,81,22,26,14,18,24,19,13,18,48,32,43,31,-1
23.10.2025,2025,eurocup,160,Turk Telekom,Valencia,87,101,17,27,15,31,20,23,35,20,44,46,43,55,1
22.10.2025,2025,eurocup,164,Gran Canaria,Ulm,125,78,36,22,32,15,29,23,28,18,58,47,52,46,1
22.10.2025,2025,eurocup,169,Venezia,Hamburg,80,68,22,16,24,15,16,17,18,20,38,39,33,38,-1
22.10.2025,2025,eurocup,164,Trefl Sopot,BC Wolves,92,99,15,25,22,22,25,19,22,18,40,44,44,40,1
22.10.2025,2025,eurocup,161,Besiktas,Joventut Badalona,82,76,21,20,21,21,16,13,24,22,41,42,29,46,-1
22.10.2025,2025,eurocup,159,Lietkabelis,JL Bourg,84,80,18,20,21,16,22,20,23,24,38,37,42,47,1
23.10.2025,2025,eurocup,171,Hapoel Tel-Aviv,x,79,73,26,18,15,20,16,20,22,15,44,35,36,37,-1
23.10.2025,2025,eurocup,158,Bahcesehir Kol.,x,75,92,20,26,29,19,7,25,19,22,46,48,32,41,-1
23.10.2025,2025,eurocup,155,Cedevita Olimpija,x,75,82,24,23,24,14,13,17,14,28,47,38,30,42,-1
23.10.2025,2025,eurocup,167,Cluj-Napoca,x,73,81,22,26,14,18,24,19,13,18,48,32,43,31,-1
23.10.2025,2025,eurocup,160,Valencia,x,87,101,17,27,15,31,20,23,35,20,44,46,43,55,1
22.10.2025,2025,eurocup,164,Ulm,x,125,78,36,22,32,15,29,23,28,18,58,47,52,46,1
22.10.2025,2025,eurocup,169,Hamburg,x,80,68,22,16,24,15,16,17,18,20,38,39,33,38,-1
22.10.2025,2025,eurocup,164,BC Wolves,x,92,99,15,25,22,22,25,19,22,18,40,44,44,40,1
22.10.2025,2025,eurocup,161,Joventut Badalona,x,82,76,21,20,21,21,16,13,24,22,41,42,29,46,-1
22.10.2025,2025,eurocup,159,JL Bourg,x,84,80,18,20,21,16,22,20,23,24,38,37,42,47,1
23.10.2025,2025,champions,158,Unicaja,Petkim Spor,112,82,34,19,26,17,26,19,26,27,53,43,45,53,1
23.10.2025,2025,champions,162,Nanterre,Wurzburg,83,88,19,26,23,21,26,19,15,22,45,44,45,37,1
23.10.2025,2025,champions,164,Promitheas,Galatasaray,75,79,17,19,21,21,10,21,27,18,36,42,31,45,-1
22.10.2025,2025,champions,162,Murcia,FMP Beograd,86,50,27,10,16,14,28,13,15,13,37,30,41,28,-1
22.10.2025,2025,champions,,Hapoel Holon,Igokea,92,82,26,29,21,22,25,13,20,18,55,43,38,38,
22.10.2025,2025,champions,166,Nymburk,Vechta,93,74,29,24,24,11,19,24,21,15,53,35,43,36,-1
22.10.2025,2025,champions,156,Szczecin,Oostende,73,84,17,18,23,24,12,19,21,23,35,47,31,44,-1
22.10.2025,2025,champions,159,Manisa,Peristeri,79,77,21,23,23,17,18,17,17,20,44,40,35,37,-1
24.10.2025,2025,fiba,157,BC Dnipro,Sassari,55,98,10,21,19,30,10,22,16,25,31,49,32,41,-1
23.10.2025,2025,fiba,156,FC Porto,Limburg,80,61,12,11,23,16,20,19,25,15,23,39,39,40,1
23.10.2025,2025,fiba,162,Cholet,CSM Constanta,106,63,28,10,31,17,27,12,20,24,38,48,39,44,1
23.10.2025,2025,fiba,161,Spirou Charleroi,Maroussi,79,69,20,18,20,19,23,15,16,17,38,39,38,33,-1
23.10.2025,2025,fiba,160,Antwerp Giants,Fribourg Olympic,67,89,15,19,12,21,20,22,20,27,34,33,42,47,1
23.10.2025,2025,fiba,169,Basket Zaragoza,Anorthosis,92,77,24,19,26,17,22,24,20,17,43,43,46,37,-1
23.10.2025,2025,fiba,156,Ludwigsburg,Dijon,80,77,24,16,14,27,22,16,20,18,40,41,38,38,-1
23.10.2025,2025,fiba,157,PAOK,Szolnoki Olaj,82,66,24,19,17,13,21,8,20,26,43,30,29,46,-1
23.10.2025,2025,fiba,168,Levice,Bursaspor,63,78,18,17,13,20,18,21,14,20,35,33,39,34,-1
23.10.2025,2025,fiba,166,Tofas,Basketball Braunschweig,102,90,29,20,29,26,23,19,21,25,49,55,42,46,1
23.10.2025,2025,fiba,157,Trepca,Caledonia Gladiators,76,80,24,26,11,19,23,16,18,19,50,30,39,37,-1
23.10.2025,2025,fiba,158,AEK Larnaca,Keravnos,82,73,18,16,20,21,22,17,22,19,34,41,39,41,1
23.10.2025,2025,fiba,159,Anwil Wloclawek,Sporting CP,93,63,30,20,19,12,20,14,24,17,50,31,34,41,-1
23.10.2025,2025,fiba,162,Balkan,Kutaisi,78,86,19,11,17,17,25,29,17,29,30,34,54,46,1
23.10.2025,2025,fiba,149,CSM Oradea,Arges Pitesti,78,74,14,18,24,24,23,12,17,20,32,48,35,37,-1
23.10.2025,2025,fiba,151,Parnu,Spojnia Stargard,72,89,19,22,15,29,20,16,18,22,41,44,36,40,1
23.10.2025,2025,fiba,161,Sabah Baku,Norrkoping,70,74,16,17,24,18,14,22,16,17,33,42,36,33,-1
22.10.2025,2025,fiba,160,Sassari,BC Dnipro,94,62,28,17,25,13,25,17,16,15,45,38,42,31,-1
22.10.2025,2025,fiba,160,BC Prievidza,Bilbao,61,84,24,22,9,20,15,16,13,26,46,29,31,39,-1
22.10.2025,2025,fiba,166,BC Kalev/Cramo,Alba Fehervar,95,89,26,24,29,19,20,29,20,17,50,48,49,37,1
22.10.2025,2025,fiba,158,Rilski Sportist,Le Portel,60,80,13,17,17,20,22,22,8,21,30,37,44,29,-1
18.10.2025,2025,fiba,154,Sporting CP,BC Dnipro,70,78,17,20,24,23,18,17,11,18,37,47,35,29,-1
23.10.2025,2025,champions,158,Petkim Spor,x,112,82,34,19,26,17,26,19,26,27,53,43,45,53,1
23.10.2025,2025,champions,162,Wurzburg,x,83,88,19,26,23,21,26,19,15,22,45,44,45,37,1
23.10.2025,2025,champions,164,Galatasaray,x,75,79,17,19,21,21,10,21,27,18,36,42,31,45,-1
22.10.2025,2025,champions,162,FMP Beograd,x,86,50,27,10,16,14,28,13,15,13,37,30,41,28,-1
22.10.2025,2025,champions,,Igokea,x,92,82,26,29,21,22,25,13,20,18,55,43,38,38,
22.10.2025,2025,champions,166,Vechta,x,93,74,29,24,24,11,19,24,21,15,53,35,43,36,-1
22.10.2025,2025,champions,156,Oostende,x,73,84,17,18,23,24,12,19,21,23,35,47,31,44,-1
22.10.2025,2025,champions,159,Peristeri,x,79,77,21,23,23,17,18,17,17,20,44,40,35,37,-1
24.10.2025,2025,fiba,157,Sassari,x,55,98,10,21,19,30,10,22,16,25,31,49,32,41,-1
23.10.2025,2025,fiba,156,Limburg,x,80,61,12,11,23,16,20,19,25,15,23,39,39,40,1
23.10.2025,2025,fiba,162,CSM Constanta,x,106,63,28,10,31,17,27,12,20,24,38,48,39,44,1
23.10.2025,2025,fiba,161,Maroussi,x,79,69,20,18,20,19,23,15,16,17,38,39,38,33,-1
23.10.2025,2025,fiba,160,Fribourg Olympic,x,67,89,15,19,12,21,20,22,20,27,34,33,42,47,1
23.10.2025,2025,fiba,169,Anorthosis,x,92,77,24,19,26,17,22,24,20,17,43,43,46,37,-1
23.10.2025,2025,fiba,156,Dijon,x,80,77,24,16,14,27,22,16,20,18,40,41,38,38,-1
23.10.2025,2025,fiba,157,Szolnoki Olaj,x,82,66,24,19,17,13,21,8,20,26,43,30,29,46,-1
23.10.2025,2025,fiba,168,Bursaspor,x,63,78,18,17,13,20,18,21,14,20,35,33,39,34,-1
23.10.2025,2025,fiba,166,Basketball Braunschweig,x,102,90,29,20,29,26,23,19,21,25,49,55,42,46,1
23.10.2025,2025,fiba,157,Caledonia Gladiators,x,76,80,24,26,11,19,23,16,18,19,50,30,39,37,-1
23.10.2025,2025,fiba,158,Keravnos,x,82,73,18,16,20,21,22,17,22,19,34,41,39,41,1
23.10.2025,2025,fiba,159,Sporting CP,x,93,63,30,20,19,12,20,14,24,17,50,31,34,41,-1
23.10.2025,2025,fiba,162,Kutaisi,x,78,86,19,11,17,17,25,29,17,29,30,34,54,46,1
23.10.2025,2025,fiba,149,Arges Pitesti,x,78,74,14,18,24,24,23,12,17,20,32,48,35,37,-1
23.10.2025,2025,fiba,151,Spojnia Stargard,x,72,89,19,22,15,29,20,16,18,22,41,44,36,40,1
23.10.2025,2025,fiba,161,Norrkoping,x,70,74,16,17,24,18,14,22,16,17,33,42,36,33,-1
22.10.2025,2025,fiba,160,BC Dnipro,x,94,62,28,17,25,13,25,17,16,15,45,38,42,31,-1
22.10.2025,2025,fiba,160,Bilbao,x,61,84,24,22,9,20,15,16,13,26,46,29,31,39,-1
22.10.2025,2025,fiba,166,Alba Fehervar,x,95,89,26,24,29,19,20,29,20,17,50,48,49,37,1
22.10.2025,2025,fiba,158,Le Portel,x,60,80,13,17,17,20,22,22,8,21,30,37,44,29,-1
18.10.2025,2025,fiba,154,BC Dnipro,x,70,78,17,20,24,23,18,17,11,18,37,47,35,29,-1
25.10.2025,2025,eurolig,161,Bayern,Olympiacos,84,80,20,19,12,24,27,18,25,19,39,36,45,44,1
25.10.2025,2025,eurolig,161,Barcelona,Lyon-Villeurbanne,90,83,17,20,26,24,26,25,21,14,37,50,51,35,1
25.10.2025,2025,eurolig,160,Fenerbahce,Panathinaikos,76,81,15,21,20,25,19,16,22,19,36,45,35,41,-1
24.10.2025,2025,eurolig,165,Real Madrid,Crvena zvezda,95,72,22,10,24,19,25,25,24,18,32,43,50,42,1
24.10.2025,2025,eurolig,164,Baskonia,Alba Berlin,80,57,24,13,15,13,24,14,17,17,37,28,38,34,-1
24.10.2025,2025,eurolig,159,Olimpia Milano,Anadolu Efes,84,96,11,23,14,23,34,20,25,30,34,37,54,55,1
24.10.2025,2025,eurolig,168,Monaco,Paris,80,87,22,25,21,24,21,14,16,24,47,45,35,40,-1
24.10.2025,2025,eurolig,161,Zalgiris Kaunas,Maccabi Tel Aviv,78,63,26,7,18,17,15,22,19,17,33,35,37,36,-1
23.10.2025,2025,eurolig,165,Partizan,Virtus Bologna,69,70,20,15,17,17,24,25,8,13,35,34,49,21,-1
25.10.2025,2025,eurolig,161,Olympiacos,x,84,80,20,19,12,24,27,18,25,19,39,36,45,44,1
25.10.2025,2025,eurolig,161,Lyon-Villeurbanne,x,90,83,17,20,26,24,26,25,21,14,37,50,51,35,1
25.10.2025,2025,eurolig,160,Panathinaikos,x,76,81,15,21,20,25,19,16,22,19,36,45,35,41,-1
24.10.2025,2025,eurolig,165,Crvena zvezda,x,95,72,22,10,24,19,25,25,24,18,32,43,50,42,1
24.10.2025,2025,eurolig,164,Alba Berlin,x,80,57,24,13,15,13,24,14,17,17,37,28,38,34,-1
24.10.2025,2025,eurolig,159,Anadolu Efes,x,84,96,11,23,14,23,34,20,25,30,34,37,54,55,1
24.10.2025,2025,eurolig,168,Paris,x,80,87,22,25,21,24,21,14,16,24,47,45,35,40,-1
24.10.2025,2025,eurolig,161,Maccabi Tel Aviv,x,78,63,26,7,18,17,15,22,19,17,33,35,37,36,-1
23.10.2025,2025,eurolig,165,Virtus Bologna,x,69,70,20,15,17,17,24,25,8,13,35,34,49,21,-1
27.10.2025,2025,fra,154,Saint Quentin,Lyon-Villeurbanne,63,77,11,22,10,17,21,24,21,14,33,27,45,35,1
27.10.2025,2025,fra,156,Gravelines-Dunkerque,JL Bourg,75,83,19,17,16,28,20,15,20,23,36,44,35,43,-1
27.10.2025,2025,fra,167,Nanterre,Chalon/Saone,91,70,20,24,21,17,30,16,20,13,44,38,46,33,-1
26.10.2025,2025,fra,166,Cholet,Paris,90,80,25,27,18,14,22,19,25,20,52,32,41,45,1
26.10.2025,2025,fra,163,Nancy,Monaco,77,98,21,17,13,30,21,31,22,20,38,43,52,42,1
26.10.2025,2025,fra,154,Dijon,La Rochelle,88,95,26,32,19,19,25,21,18,23,58,38,46,41,1
26.10.2025,2025,fra,160,Le Mans,Le Portel,77,74,22,20,18,16,18,10,19,28,42,34,28,47,-1
25.10.2025,2025,fra,158,Strasbourg,Limoges,110,90,26,19,25,17,22,22,37,32,45,42,44,69,1
26.10.2025,2025,fra b,158,Orleans,Hyeres-Toulon,78,65,13,12,24,9,20,22,21,22,25,33,42,43,1
25.10.2025,2025,fra b,156,Poitiers,Boulazac,76,86,17,15,27,28,16,21,16,22,32,55,37,38,-1
25.10.2025,2025,fra b,161,Antibes,Evreux,73,71,21,26,15,12,18,10,19,23,47,27,28,42,-1
25.10.2025,2025,fra b,158,Chalons-Reims,Pau-Orthez,84,78,18,16,17,22,17,21,32,19,34,39,38,51,1
25.10.2025,2025,fra b,168,Rouen,Aix Maurienne,78,90,28,27,19,12,14,26,17,25,55,31,40,42,-1
25.10.2025,2025,fra b,164,St. Chamond,Caen,73,79,10,22,24,15,17,20,22,22,32,39,37,44,-1
25.10.2025,2025,fra b,161,Vichy,Nantes,81,66,17,22,19,15,22,13,23,16,39,34,35,39,-1
25.10.2025,2025,fra b,164,Denain-Voltaire,Chartres,86,88,20,19,16,12,26,36,24,21,39,28,62,45,1
25.10.2025,2025,fra b,156,Fos-sur-Mer,Ada Blois,63,65,12,17,10,21,16,16,25,11,29,31,32,36,-1
25.10.2025,2025,fra b,165,Roanne,ASA,111,106,23,22,23,32,24,18,24,22,45,55,42,46,1
27.10.2025,2025,fra,154,Lyon-Villeurbanne,x,63,77,11,22,10,17,21,24,21,14,33,27,45,35,1
27.10.2025,2025,fra,156,JL Bourg,x,75,83,19,17,16,28,20,15,20,23,36,44,35,43,-1
27.10.2025,2025,fra,167,Chalon/Saone,x,91,70,20,24,21,17,30,16,20,13,44,38,46,33,-1
26.10.2025,2025,fra,166,Paris,x,90,80,25,27,18,14,22,19,25,20,52,32,41,45,1
26.10.2025,2025,fra,163,Monaco,x,77,98,21,17,13,30,21,31,22,20,38,43,52,42,1
26.10.2025,2025,fra,154,La Rochelle,x,88,95,26,32,19,19,25,21,18,23,58,38,46,41,1
26.10.2025,2025,fra,160,Le Portel,x,77,74,22,20,18,16,18,10,19,28,42,34,28,47,-1
25.10.2025,2025,fra,158,Limoges,x,110,90,26,19,25,17,22,22,37,32,45,42,44,69,1
26.10.2025,2025,fra b,158,Hyeres-Toulon,x,78,65,13,12,24,9,20,22,21,22,25,33,42,43,1
25.10.2025,2025,fra b,156,Boulazac,x,76,86,17,15,27,28,16,21,16,22,32,55,37,38,-1
25.10.2025,2025,fra b,161,Evreux,x,73,71,21,26,15,12,18,10,19,23,47,27,28,42,-1
25.10.2025,2025,fra b,158,Pau-Orthez,x,84,78,18,16,17,22,17,21,32,19,34,39,38,51,1
25.10.2025,2025,fra b,168,Aix Maurienne,x,78,90,28,27,19,12,14,26,17,25,55,31,40,42,-1
25.10.2025,2025,fra b,164,Caen,x,73,79,10,22,24,15,17,20,22,22,32,39,37,44,-1
25.10.2025,2025,fra b,161,Nantes,x,81,66,17,22,19,15,22,13,23,16,39,34,35,39,-1
25.10.2025,2025,fra b,164,Chartres,x,86,88,20,19,16,12,26,36,24,21,39,28,62,45,1
25.10.2025,2025,fra b,156,Ada Blois,x,63,65,12,17,10,21,16,16,25,11,29,31,32,36,-1
25.10.2025,2025,fra b,165,ASA,x,111,106,23,22,23,32,24,18,24,22,45,55,42,46,1
27.10.2025,2025,ger b,170,Giessen,Vechta 2,87,73,26,14,22,17,22,22,17,20,40,39,44,37,-1
26.10.2025,2025,ger b,173,Crailsheim Merlins,Artland,80,62,16,20,26,13,20,14,18,15,36,39,34,33,-1
26.10.2025,2025,ger b,152,Koblenz,PS Karlsruhe,71,67,11,15,15,14,23,15,22,23,26,29,38,45,1
26.10.2025,2025,ger b,162,Tubingen,Phoenix Hagen,83,71,23,22,18,15,16,11,26,23,45,33,27,49,-1
26.10.2025,2025,ger b,163,Bochum,Munster,77,78,17,17,23,12,22,21,15,28,34,35,43,43,1
26.10.2025,2025,ger b,175,Dusseldorf,Bayreuth,87,88,22,30,22,18,22,18,21,22,52,40,40,43,-1
26.10.2025,2025,ger b,161,Kirchheim,Dresden,86,76,21,21,23,16,21,30,21,9,42,39,51,30,1
26.10.2025,2025,ger b,160,Jena,Trier,85,91,16,19,32,17,22,29,15,26,35,49,51,41,1
26.10.2025,2025,ger b,160,Nurnberger,Bremerhaven,73,84,19,24,19,11,18,24,17,25,43,30,42,42,1
27.10.2025,2025,ger,160,Bayern,Wurzburg,70,69,18,18,10,15,21,20,21,16,36,25,41,37,-1
27.10.2025,2025,ger,164,Alba Berlin,Basketball Braunschweig,65,61,17,14,20,17,17,9,11,21,31,37,26,32,-1
27.10.2025,2025,ger,160,Rostock,Chemnitz,60,68,17,16,20,19,12,12,11,21,33,39,24,32,-1
26.10.2025,2025,ger,170,Hamburg,Syntainics MBC,75,96,17,21,13,28,17,19,28,28,38,41,36,56,1
26.10.2025,2025,ger,160,Frankfurt,Heidelberg,72,95,16,20,23,23,12,28,21,24,36,46,40,45,1
26.10.2025,2025,ger,165,Ulm,Vechta,85,76,25,18,25,14,16,26,19,18,43,39,42,37,-1
25.10.2025,2025,ger,169,Oldenburg,Bamberg,67,59,15,17,20,11,14,18,18,13,32,31,32,31,-1
27.10.2025,2025,ger b,170,Vechta 2,x,87,73,26,14,22,17,22,22,17,20,40,39,44,37,-1
26.10.2025,2025,ger b,173,Artland,x,80,62,16,20,26,13,20,14,18,15,36,39,34,33,-1
26.10.2025,2025,ger b,152,PS Karlsruhe,x,71,67,11,15,15,14,23,15,22,23,26,29,38,45,1
26.10.2025,2025,ger b,162,Phoenix Hagen,x,83,71,23,22,18,15,16,11,26,23,45,33,27,49,-1
26.10.2025,2025,ger b,163,Munster,x,77,78,17,17,23,12,22,21,15,28,34,35,43,43,1
26.10.2025,2025,ger b,175,Bayreuth,x,87,88,22,30,22,18,22,18,21,22,52,40,40,43,-1
26.10.2025,2025,ger b,161,Dresden,x,86,76,21,21,23,16,21,30,21,9,42,39,51,30,1
26.10.2025,2025,ger b,160,Trier,x,85,91,16,19,32,17,22,29,15,26,35,49,51,41,1
26.10.2025,2025,ger b,160,Bremerhaven,x,73,84,19,24,19,11,18,24,17,25,43,30,42,42,1
27.10.2025,2025,ger,160,Wurzburg,x,70,69,18,18,10,15,21,20,21,16,36,25,41,37,-1
27.10.2025,2025,ger,164,Basketball Braunschweig,x,65,61,17,14,20,17,17,9,11,21,31,37,26,32,-1
27.10.2025,2025,ger,160,Chemnitz,x,60,68,17,16,20,19,12,12,11,21,33,39,24,32,-1
26.10.2025,2025,ger,170,Syntainics MBC,x,75,96,17,21,13,28,17,19,28,28,38,41,36,56,1
26.10.2025,2025,ger,160,Heidelberg,x,72,95,16,20,23,23,12,28,21,24,36,46,40,45,1
26.10.2025,2025,ger,165,Vechta,x,85,76,25,18,25,14,16,26,19,18,43,39,42,37,-1
25.10.2025,2025,ger,169,Bamberg,x,67,59,15,17,20,11,14,18,18,13,32,31,32,31,-1
27.10.2025,2025,greek,158,Olympiacos,Panathinaikos,71,78,23,23,15,25,17,14,16,16,46,40,31,32,-1
27.10.2025,2025,greek,160,Promitheas,AS Karditsas,96,79,27,20,20,23,28,16,21,20,47,43,44,41,1
26.10.2025,2025,greek,152,Panionios,Maroussi,86,62,21,16,30,10,20,13,15,23,37,40,33,38,-1
26.10.2025,2025,greek,151,Kolossos Rhodes,Aris,84,85,23,15,20,13,24,30,17,27,38,33,54,44,1
26.10.2025,2025,greek,158,PAOK,AEK Athens,87,82,19,24,29,25,17,12,22,21,43,54,29,43,-1
27.10.2025,2025,greek,158,Panathinaikos,x,71,78,23,23,15,25,17,14,16,16,46,40,31,32,-1
27.10.2025,2025,greek,160,AS Karditsas,x,96,79,27,20,20,23,28,16,21,20,47,43,44,41,1
26.10.2025,2025,greek,152,Maroussi,x,86,62,21,16,30,10,20,13,15,23,37,40,33,38,-1
26.10.2025,2025,greek,151,Aris,x,84,85,23,15,20,13,24,30,17,27,38,33,54,44,1
26.10.2025,2025,greek,158,AEK Athens,x,87,82,19,24,29,25,17,12,22,21,43,54,29,43,-1
27.10.2025,2025,kıbrıs,160,Apollon,ETHA Engomi,92,73,26,19,21,18,20,20,25,16,45,39,40,41,1
27.10.2025,2025,kıbrıs,168,Keravnos,Anorthosis,89,87,29,19,25,20,17,25,18,23,48,45,42,41,-1
26.10.2025,2025,kıbrıs,161,AEL,Paralimni,99,67,28,20,27,11,27,19,17,17,48,38,46,34,-1
25.10.2025,2025,kıbrıs,159,Apoel BC,Achilleas K.,95,71,26,21,33,19,20,8,16,23,47,52,28,39,-1
20.10.2025,2025,kıbrıs,151,Anorthosis,Apoel BC,94,74,26,22,21,16,28,20,19,16,48,37,48,35,1
19.10.2025,2025,kıbrıs,157,Achilleas K.,AEK Larnaca,69,93,14,22,19,28,15,26,21,17,36,47,41,38,1
19.10.2025,2025,kıbrıs,158,Paralimni,Keravnos,76,88,25,18,22,17,7,27,22,26,43,39,34,48,1
18.10.2025,2025,kıbrıs,157,ETHA Engomi,AEL,57,84,14,21,25,20,7,29,11,14,35,45,36,25,-1
27.10.2025,2025,kıbrıs,160,ETHA Engomi,x,92,73,26,19,21,18,20,20,25,16,45,39,40,41,1
27.10.2025,2025,kıbrıs,168,Anorthosis,x,89,87,29,19,25,20,17,25,18,23,48,45,42,41,-1
26.10.2025,2025,kıbrıs,161,Paralimni,x,99,67,28,20,27,11,27,19,17,17,48,38,46,34,-1
25.10.2025,2025,kıbrıs,159,Achilleas K.,x,95,71,26,21,33,19,20,8,16,23,47,52,28,39,-1
20.10.2025,2025,kıbrıs,151,Apoel BC,x,94,74,26,22,21,16,28,20,19,16,48,37,48,35,1
19.10.2025,2025,kıbrıs,157,AEK Larnaca,x,69,93,14,22,19,28,15,26,21,17,36,47,41,38,1
19.10.2025,2025,kıbrıs,158,Keravnos,x,76,88,25,18,22,17,7,27,22,26,43,39,34,48,1
18.10.2025,2025,kıbrıs,157,AEL,x,57,84,14,21,25,20,7,29,11,14,35,45,36,25,-1
27.10.2025,2025,ita,182,Varese,Pistoia,102,95,26,18,21,32,31,14,24,31,44,53,45,55,1
27.10.2025,2025,ita,166,Sassari,Trento,81,84,19,26,19,20,21,23,22,15,45,39,44,37,-1
27.10.2025,2025,ita,165,Venezia,Scafati,75,69,19,23,18,17,18,17,20,12,42,35,35,32,-1
26.10.2025,2025,ita,166,Reggiana,Brescia,68,80,20,19,9,22,19,19,20,20,39,31,38,40,-1
26.10.2025,2025,ita,166,Olimpia Milano,Basket Napoli,89,82,20,13,19,22,27,26,23,21,33,41,53,44,1
26.10.2025,2025,ita,164,Treviso,Trieste,95,100,29,27,28,25,12,22,26,26,56,53,34,52,1
26.10.2025,2025,ita,171,Trapani,Tortona,78,84,19,16,25,27,15,21,19,20,35,52,36,39,-1
26.10.2025,2025,ita,155,Cremona,Virtus Bologna,69,74,20,15,17,17,17,23,15,19,35,34,40,34,-1
27.10.2025,2025,ita b,152,Brindisi,Nardo,63,76,20,18,18,14,14,22,11,22,38,32,36,33,-1
27.10.2025,2025,ita b,150,Cantu,Cento,85,65,24,16,29,11,13,22,19,16,40,40,35,35,-1
27.10.2025,2025,ita b,158,Orzinuovi,Basket Torino,82,71,23,19,30,16,18,18,11,18,42,46,36,29,-1
27.10.2025,2025,ita b,153,Rimini,Forli,81,73,17,20,20,27,22,9,22,17,37,47,31,39,-1
27.10.2025,2025,ita b,148,Sebastiani Rieti,Libertas Livorno,97,78,28,24,21,17,33,14,15,23,52,38,47,38,1
27.10.2025,2025,ita b,157,Verona,JuVi Cremona,85,71,29,20,18,22,16,18,22,11,49,40,34,33,-1
26.10.2025,2025,ita b,157,Urania Milano,Pesaro,77,60,19,20,17,13,20,11,21,16,39,30,31,37,-1
26.10.2025,2025,ita b,154,Assigeco Piacenza,Udine,74,96,11,28,11,26,30,28,22,14,39,37,58,36,1
25.10.2025,2025,ita b,155,Cividale,Vigevano,73,68,16,10,14,18,22,19,21,21,26,32,41,42,1
21.10.2025,2025,ita b,146,Sebastiani Rieti,Brindisi,74,73,15,18,12,21,22,17,25,17,33,33,39,42,1
27.10.2025,2025,ita,182,Pistoia,x,102,95,26,18,21,32,31,14,24,31,44,53,45,55,1
27.10.2025,2025,ita,166,Trento,x,81,84,19,26,19,20,21,23,22,15,45,39,44,37,-1
27.10.2025,2025,ita,165,Scafati,x,75,69,19,23,18,17,18,17,20,12,42,35,35,32,-1
26.10.2025,2025,ita,166,Brescia,x,68,80,20,19,9,22,19,19,20,20,39,31,38,40,-1
26.10.2025,2025,ita,166,Basket Napoli,x,89,82,20,13,19,22,27,26,23,21,33,41,53,44,1
26.10.2025,2025,ita,164,Trieste,x,95,100,29,27,28,25,12,22,26,26,56,53,34,52,1
26.10.2025,2025,ita,171,Tortona,x,78,84,19,16,25,27,15,21,19,20,35,52,36,39,-1
26.10.2025,2025,ita,155,Virtus Bologna,x,69,74,20,15,17,17,17,23,15,19,35,34,40,34,-1
27.10.2025,2025,ita b,152,Nardo,x,63,76,20,18,18,14,14,22,11,22,38,32,36,33,-1
27.10.2025,2025,ita b,150,Cento,x,85,65,24,16,29,11,13,22,19,16,40,40,35,35,-1
27.10.2025,2025,ita b,158,Basket Torino,x,82,71,23,19,30,16,18,18,11,18,42,46,36,29,-1
27.10.2025,2025,ita b,153,Forli,x,81,73,17,20,20,27,22,9,22,17,37,47,31,39,-1
27.10.2025,2025,ita b,148,Libertas Livorno,x,97,78,28,24,21,17,33,14,15,23,52,38,47,38,1
27.10.2025,2025,ita b,157,JuVi Cremona,x,85,71,29,20,18,22,16,18,22,11,49,40,34,33,-1
26.10.2025,2025,ita b,157,Pesaro,x,77,60,19,20,17,13,20,11,21,16,39,30,31,37,-1
26.10.2025,2025,ita b,154,Udine,x,74,96,11,28,11,26,30,28,22,14,39,37,58,36,1
25.10.2025,2025,ita b,155,Vigevano,x,73,68,16,10,14,18,22,19,21,21,26,32,41,42,1
21.10.2025,2025,ita b,146,Brindisi,x,74,73,15,18,12,21,22,17,25,17,33,33,39,42,1
26.10.2025,2025,lat nkl,166,Kretinga,Ukmerges Stekas,69,64,10,21,25,17,15,17,19,9,31,42,32,28,-1
26.10.2025,2025,lat nkl,165,Jurbarkas,Delikatesas Joniskis,97,74,27,12,25,23,28,21,17,18,39,48,49,35,1
26.10.2025,2025,lat nkl,157,Alytaus Alytus,BC Olimpas Palanga,73,91,21,26,10,15,24,22,18,28,47,25,46,46,1
26.10.2025,2025,lat nkl,160,Silute,Suduva-Mantinga,89,97,15,24,16,29,24,25,34,19,39,45,49,53,1
26.10.2025,2025,lat nkl,158,Telsiai,Omega-Tauras,92,70,27,19,21,18,15,20,29,13,46,39,35,42,-1
26.10.2025,2025,lat nkl,152,Zalgiris Kaunas 2,Neptunas 2,84,73,19,22,25,9,20,21,20,21,41,34,41,41,1
26.10.2025,2025,lat nkl,168,Vilkaviskis,Rytas 2,92,76,20,13,19,22,25,25,28,16,33,41,50,44,1
27.10.2025,2025,lat-st,157,Viimsi,Keila Coolbet,70,77,14,14,22,16,13,28,21,19,28,38,41,40,1
26.10.2025,2025,lat-st,153,Tartu Ulikool,BC Kalev/Cramo,81,85,20,21,25,23,23,14,13,27,41,48,37,40,1
26.10.2025,2025,lat-st,164,Rigas Zelli,BK Ogre,88,71,23,23,24,7,17,21,24,20,46,31,38,44,-1
26.10.2025,2025,lat-st,155,Parnu,Valmiera Glass Via,83,78,17,12,13,22,23,22,30,22,29,35,45,52,1
26.10.2025,2025,lat-st,154,Rapla,Latvijas Universitate,79,60,16,17,22,16,21,20,20,7,33,38,41,27,-1
26.10.2025,2025,lat-st,174,Tal Tech,Ventspils,93,87,30,22,19,20,22,18,22,27,52,39,40,49,1
23.10.2025,2025,lat-st,167,Keila Coolbet,Keila KK,83,72,24,17,15,15,24,20,20,20,41,30,44,40,1
23.10.2025,2025,lat-st,159,Tal Tech,VEF Riga,80,93,15,19,18,23,18,29,29,22,34,41,47,51,1
26.10.2025,2025,lat lkl,170,Plunges Olimpas,Vytis VDU,100,86,38,23,18,24,24,15,20,24,61,42,39,44,-1
24.10.2025,2025,lat lkl,160,BC Olimpas Palanga,Kretinga,66,48,16,15,13,10,17,12,20,11,31,23,29,31,-1
24.10.2025,2025,lat lkl,158,Omega-Tauras,Plunges Olimpas,80,72,18,13,25,19,21,25,16,15,31,44,46,31,-1
24.10.2025,2025,lat lkl,167,Vytis VDU,Zalgiris Kaunas 2,90,100,18,25,23,30,25,28,24,17,43,53,53,41,1
26.10.2025,2025,lat nkl,166,Ukmerges Stekas,x,69,64,10,21,25,17,15,17,19,9,31,42,32,28,-1
26.10.2025,2025,lat nkl,165,Delikatesas Joniskis,x,97,74,27,12,25,23,28,21,17,18,39,48,49,35,1
26.10.2025,2025,lat nkl,157,BC Olimpas Palanga,x,73,91,21,26,10,15,24,22,18,28,47,25,46,46,1
26.10.2025,2025,lat nkl,170,Vytis VDU,x,100,86,38,23,18,24,24,15,20,24,61,42,39,44,-1
26.10.2025,2025,lat nkl,160,Suduva-Mantinga,x,89,97,15,24,16,29,24,25,34,19,39,45,49,53,1
26.10.2025,2025,lat nkl,152,Neptunas 2,x,84,73,19,22,25,9,20,21,20,21,41,34,41,41,1
26.10.2025,2025,lat nkl,168,Rytas 2,x,92,76,20,13,19,22,25,25,28,16,33,41,50,44,1
27.10.2025,2025,lat-st,157,Keila Coolbet,x,70,77,14,14,22,16,13,28,21,19,28,38,41,40,1
26.10.2025,2025,lat-st,153,BC Kalev/Cramo,x,81,85,20,21,25,23,23,14,13,27,41,48,37,40,1
26.10.2025,2025,lat-st,164,BK Ogre,x,88,71,23,23,24,7,17,21,24,20,46,31,38,44,-1
26.10.2025,2025,lat-st,155,Valmiera Glass Via,x,83,78,17,12,13,22,23,22,30,22,29,35,45,52,1
26.10.2025,2025,lat-st,154,Latvijas Universitate,x,79,60,16,17,22,16,21,20,20,7,33,38,41,27,-1
26.10.2025,2025,lat-st,174,Ventspils,x,93,87,30,22,19,20,22,18,22,27,52,39,40,49,1
23.10.2025,2025,lat-st,167,Keila KK,x,83,72,24,17,15,15,24,20,20,20,41,30,44,40,1
23.10.2025,2025,lat-st,159,VEF Riga,x,80,93,15,19,18,23,18,29,29,22,34,41,47,51,1
26.10.2025,2025,lat lkl,158,Omega-Tauras,x,92,70,27,19,21,18,15,20,29,13,46,39,35,42,-1
24.10.2025,2025,lat lkl,170,Silute,x,102,66,29,19,30,18,22,17,21,12,48,48,39,33,-1
24.10.2025,2025,lat lkl,160,Telsiai,x,94,92,10,16,19,24,23,23,25,14,26,43,46,39,1
24.10.2025,2025,lat lkl,158,Plunges Olimpas,x,80,72,18,13,25,19,21,25,16,15,31,44,46,31,-1
24.10.2025,2025,lat lkl,167,Zalgiris Kaunas 2,x,90,100,18,25,23,30,25,28,24,17,43,53,53,41,1
26.10.2025,2025,mac,174,Zalakeramia,Pecsi VSK,101,72,21,21,18,26,27,8,35,17,42,44,35,52,-1
26.10.2025,2025,mac,170,NKA Pecs,Kormend,87,96,16,24,22,28,26,15,23,29,40,50,41,52,1
26.10.2025,2025,mac,161,OSE Lions,Szombathely,69,102,18,23,23,25,22,30,6,24,41,48,52,30,1
26.10.2025,2025,mac,170,Szolnoki Olaj,Alba Fehervar,96,87,25,27,28,21,31,14,12,25,52,49,45,37,-1
25.10.2025,2025,mac,160,Soproni KC,Szedeak,87,67,24,9,22,18,19,18,22,22,33,40,37,44,1
24.10.2025,2025,mac,151,Budapesti Honved Se,KTE-Duna,58,87,15,18,7,28,17,23,19,18,33,35,40,37,1
24.10.2025,2025,mac,159,DEAC,Atomeromu Paks,54,82,15,22,11,19,14,22,14,19,37,30,36,33,-1
26.10.2025,2025,mac,174,Pecsi VSK,x,101,72,21,21,18,26,27,8,35,17,42,44,35,52,-1
26.10.2025,2025,mac,170,Kormend,x,87,96,16,24,22,28,26,15,23,29,40,50,41,52,1
26.10.2025,2025,mac,161,Szombathely,x,69,102,18,23,23,25,22,30,6,24,41,48,52,30,1
26.10.2025,2025,mac,170,Alba Fehervar,x,96,87,25,27,28,21,31,14,12,25,52,49,45,37,-1
25.10.2025,2025,mac,160,Szedeak,x,87,67,24,9,22,18,19,18,22,22,33,40,37,44,1
24.10.2025,2025,mac,151,KTE-Duna,x,58,87,15,18,7,28,17,23,19,18,33,35,40,37,1
24.10.2025,2025,mac,159,Atomeromu Paks,x,54,82,15,22,11,19,14,22,14,19,37,30,36,33,-1
27.10.2025,2025,mak,152,Feniks 2010,TFT Skopje,63,80,13,20,22,29,18,13,10,18,33,51,31,28,-1
27.10.2025,2025,mak,164,Rabotnicki,Cair 2030,86,63,17,22,26,12,21,13,22,16,39,38,34,38,-1
26.10.2025,2025,mak,156,Gostivar,Pelister,77,66,23,20,19,13,19,15,16,18,43,32,34,34,-1
26.10.2025,2025,mak,162,Kozuv,Tikvesh,85,64,18,16,25,18,23,18,19,12,34,43,41,31,-1
26.10.2025,2025,mak,155,Shkupi Skopje,Vardar,89,68,21,21,27,16,18,15,23,16,42,43,33,39,-1
26.10.2025,2025,mak,154,MZT Skopje,MKK Kumanovo,78,71,19,20,21,16,27,22,11,13,39,37,49,24,-1
20.10.2025,2025,mak,,Pelister,MKK Kumanovo,88,74,25,30,25,17,21,19,17,8,55,42,40,25,
27.10.2025,2025,mak,152,TFT Skopje,x,63,80,13,20,22,29,18,13,10,18,33,51,31,28,-1
27.10.2025,2025,mak,164,Cair 2030,x,86,63,17,22,26,12,21,13,22,16,39,38,34,38,-1
26.10.2025,2025,mak,156,Pelister,x,77,66,23,20,19,13,19,15,16,18,43,32,34,34,-1
26.10.2025,2025,mak,162,Tikvesh,x,85,64,18,16,25,18,23,18,19,12,34,43,41,31,-1
26.10.2025,2025,mak,155,Vardar,x,89,68,21,21,27,16,18,15,23,16,42,43,33,39,-1
26.10.2025,2025,mak,154,MKK Kumanovo,x,78,71,19,20,21,16,27,22,11,13,39,37,49,24,-1
20.10.2025,2025,mak,,MKK Kumanovo,x,88,74,25,30,25,17,21,19,17,8,55,42,40,25,
27.10.2025,2025,pol,172,Dabrowa Gornicza,Gdynia,100,93,34,21,20,21,19,25,27,26,55,41,44,53,1
27.10.2025,2025,pol,158,Legia,Dziki Warszawa,73,66,23,12,17,20,18,19,15,15,35,37,37,30,-1
27.10.2025,2025,pol,161,Anwil Wloclawek,Spojnia Stargard,72,64,13,16,17,17,23,11,19,20,29,34,34,39,-1
26.10.2025,2025,pol,163,Trefl Sopot,Ostrow Wielkopolski,96,81,26,20,23,18,24,25,23,18,46,41,49,41,1
26.10.2025,2025,pol,163,Torun,Czarni Slupsk,78,96,23,24,11,27,27,25,17,20,47,38,52,37,1
27.10.2025,2025,pol,172,Gdynia,x,100,93,34,21,20,21,19,25,27,26,55,41,44,53,1
27.10.2025,2025,pol,158,Dziki Warszawa,x,73,66,23,12,17,20,18,19,15,15,35,37,37,30,-1
27.10.2025,2025,pol,161,Spojnia Stargard,x,72,64,13,16,17,17,23,11,19,20,29,34,34,39,-1
26.10.2025,2025,pol,163,Ostrow Wielkopolski,x,96,81,26,20,23,18,24,25,23,18,46,41,49,41,1
26.10.2025,2025,pol,163,Czarni Slupsk,x,78,96,23,24,11,27,27,25,17,20,47,38,52,37,1
26.10.2025,2025,por,153,Esgueira,Galitos Barreiro,74,81,18,15,19,16,15,22,22,28,33,35,37,50,1
26.10.2025,2025,por,149,CA Queluz,Ovarense,86,87,19,24,21,17,20,26,26,20,43,38,46,46,1
26.10.2025,2025,por,158,Galomar,Benfica,83,87,27,14,19,18,13,35,24,20,41,37,48,44,1
26.10.2025,2025,por,156,Sporting CP,Imortal,96,59,22,14,24,19,23,9,27,17,36,43,32,44,-1
26.10.2025,2025,por,157,FC Porto,CD Povoa,76,64,15,18,17,19,20,13,24,14,33,36,33,38,-1
25.10.2025,2025,por,155,Oliveirense,Vitoria,93,76,27,22,21,18,22,24,23,12,49,39,46,35,1
27.10.2025,2025,por b,142,Lusitania,Imortal B,68,78,16,24,22,15,13,16,17,23,40,37,29,40,-1
27.10.2025,2025,por b,139,CAB Madeira,Benfica Lisboa B,56,57,15,9,16,13,11,20,14,15,24,29,31,29,-1
26.10.2025,2025,por b,137,Galitos Aveiro,Illiabum,60,73,22,23,9,17,21,13,8,20,45,26,34,28,-1
26.10.2025,2025,por b,155,Vasco Da Gama,Maia,82,77,20,21,21,14,13,23,28,19,41,35,36,47,1
26.10.2025,2025,por b,144,Portimonense,CB Queluz,84,72,22,15,21,22,14,25,27,10,37,43,39,37,1
26.10.2025,2025,por b,146,Sangalhos,Sampaense,91,85,31,16,22,16,19,24,19,29,47,38,43,48,1
26.10.2025,2025,por b,144,Santo Andre,Barreirense,66,55,14,17,12,11,22,20,18,7,31,23,42,25,-1
26.10.2025,2025,por b,151,Ginasio,Braga,78,84,26,25,8,22,15,19,29,18,51,30,34,47,1
26.10.2025,2025,por,153,Galitos Barreiro,x,74,81,18,15,19,16,15,22,22,28,33,35,37,50,1
26.10.2025,2025,por,149,Ovarense,x,86,87,19,24,21,17,20,26,26,20,43,38,46,46,1
26.10.2025,2025,por,158,Benfica,x,83,87,27,14,19,18,13,35,24,20,41,37,48,44,1
26.10.2025,2025,por,156,Imortal,x,96,59,22,14,24,19,23,9,27,17,36,43,32,44,-1
26.10.2025,2025,por,157,CD Povoa,x,76,64,15,18,17,19,20,13,24,14,33,36,33,38,-1
25.10.2025,2025,por,155,Vitoria,x,93,76,27,22,21,18,22,24,23,12,49,39,46,35,1
27.10.2025,2025,por b,142,Imortal B,x,68,78,16,24,22,15,13,16,17,23,40,37,29,40,-1
27.10.2025,2025,por b,139,Benfica Lisboa B,x,56,57,15,9,16,13,11,20,14,15,24,29,31,29,-1
26.10.2025,2025,por b,137,Illiabum,x,60,73,22,23,9,17,21,13,8,20,45,26,34,28,-1
26.10.2025,2025,por b,155,Maia,x,82,77,20,21,21,14,13,23,28,19,41,35,36,47,1
26.10.2025,2025,por b,144,CB Queluz,x,84,72,22,15,21,22,14,25,27,10,37,43,39,37,1
26.10.2025,2025,por b,146,Sampaense,x,91,85,31,16,22,16,19,24,19,29,47,38,43,48,1
26.10.2025,2025,por b,144,Barreirense,x,66,55,14,17,12,11,22,20,18,7,31,23,42,25,-1
26.10.2025,2025,por b,151,Braga,x,78,84,26,25,8,22,15,19,29,18,51,30,34,47,1
27.10.2025,2025,sır,158,OKK Novi Pazar,Cacak 94,67,84,12,16,8,28,23,23,24,17,28,36,46,41,1
27.10.2025,2025,sır,158,Vojvodina Novi Sad,Tamis,82,63,19,17,27,11,24,23,12,12,36,38,47,24,-1
26.10.2025,2025,sır,160,Radnicki,Dynamic,89,96,26,10,20,27,20,28,23,31,36,47,48,54,1
26.10.2025,2025,sır,164,Sloga,Sloboda,61,75,23,19,14,17,12,25,12,14,42,31,37,26,-1
26.10.2025,2025,sır,173,Vrsac,OKK Beograd,103,82,37,26,25,19,21,25,20,12,63,44,46,32,-1
26.10.2025,2025,sır,165,Mladost Zemun,KK Metalac,70,80,19,18,13,24,25,17,13,21,37,37,42,34,-1
26.10.2025,2025,sır,163,BBK Radnicki,Zlatibor,78,80,23,16,8,22,25,27,22,15,39,30,52,37,1
25.10.2025,2025,sır,159,Joker,KK Mladost SP,105,92,26,24,23,23,30,21,26,24,50,46,51,50,1
27.10.2025,2025,sır,158,Cacak 94,x,67,84,12,16,8,28,23,23,24,17,28,36,46,41,1
27.10.2025,2025,sır,158,Tamis,x,82,63,19,17,27,11,24,23,12,12,36,38,47,24,-1
26.10.2025,2025,sır,160,Dynamic,x,89,96,26,10,20,27,20,28,23,31,36,47,48,54,1
26.10.2025,2025,sır,164,Sloboda,x,61,75,23,19,14,17,12,25,12,14,42,31,37,26,-1
26.10.2025,2025,sır,173,OKK Beograd,x,103,82,37,26,25,19,21,25,20,12,63,44,46,32,-1
26.10.2025,2025,sır,165,KK Metalac,x,70,80,19,18,13,24,25,17,13,21,37,37,42,34,-1
26.10.2025,2025,sır,163,Zlatibor,x,78,80,23,16,8,22,25,27,22,15,39,30,52,37,1
25.10.2025,2025,sır,159,KK Mladost SP,x,105,92,26,24,23,23,30,21,26,24,50,46,51,50,1
26.10.2025,2025,rus,147,Lokomotiv Kuban 2,Novosibirsk,79,85,12,23,24,15,16,24,27,23,35,39,40,50,1
26.10.2025,2025,rus,147,Novosibirsk,x,79,85,12,23,24,15,16,24,27,23,35,39,40,50,1
23.10.2025,2025,rus cup,143,BC Moscow,Khimki M.,70,61,25,13,17,16,13,17,15,15,38,33,30,30,-1
23.10.2025,2025,rus cup,152,CSKA Moscow 2,Zenit Petersburg 2,101,69,22,10,27,23,21,15,31,21,32,50,36,52,1
23.10.2025,2025,rus cup,143,Dynamo Grozny,Novosibirsk,61,59,17,9,12,14,19,19,13,17,26,26,38,30,-1
23.10.2025,2025,rus cup,153,Lokomotiv Kuban 2,Irkutsk,74,72,17,23,20,17,17,13,20,19,40,37,30,39,-1
23.10.2025,2025,rus cup,144,Tambov,Barnaul,100,77,22,19,23,13,31,18,24,27,41,36,49,51,1
23.10.2025,2025,rus cup,146,Chelyabinsk,Dome-Springs Izhevsk,69,66,21,15,17,14,15,16,16,21,36,31,31,37,-1
23.10.2025,2025,rus cup,148,University-Ugra,Temp Sumz Revda,62,83,17,30,16,22,17,23,12,8,47,38,40,20,-1
23.10.2025,2025,rus cup,149,Dynamo Vladivostok,Bars Rostov,93,78,21,18,27,14,23,23,22,23,39,41,46,45,1
23.10.2025,2025,rus cup,143,Khimki M.,x,70,61,25,13,17,16,13,17,15,15,38,33,30,30,-1
23.10.2025,2025,rus cup,152,Zenit Petersburg 2,x,101,69,22,10,27,23,21,15,31,21,32,50,36,52,1
23.10.2025,2025,rus cup,143,Novosibirsk,x,61,59,17,9,12,14,19,19,13,17,26,26,38,30,-1
23.10.2025,2025,rus cup,153,Irkutsk,x,74,72,17,23,20,17,17,13,20,19,40,37,30,39,-1
23.10.2025,2025,rus cup,144,Barnaul,x,100,77,22,19,23,13,31,18,24,27,41,36,49,51,1
23.10.2025,2025,rus cup,146,Dome-Springs Izhevsk,x,69,66,21,15,17,14,15,16,16,21,36,31,31,37,-1
23.10.2025,2025,rus cup,148,Temp Sumz Revda,x,62,83,17,30,16,22,17,23,12,8,47,38,40,20,-1
23.10.2025,2025,rus cup,149,Bars Rostov,x,93,78,21,18,27,14,23,23,22,23,39,41,46,45,1
28.10.2025,2025,sloven,150,Helios Domzale,Tajfun Sentjur,79,65,15,18,23,15,22,17,19,15,33,38,39,34,-1
26.10.2025,2025,sloven,148,Zlatorog Lasko,KK Triglav Kranj,75,83,23,20,22,23,17,20,13,20,43,45,37,33,-1
26.10.2025,2025,sloven,155,Rogaska,Sencur,79,67,18,15,23,20,16,18,22,14,33,43,34,36,-1
25.10.2025,2025,sloven,157,LTH Castings,Podcetrtek,69,80,15,16,14,18,15,26,25,20,31,32,41,45,1
22.10.2025,2025,sloven,164,Ilirija,KK Krka Novo mesto,75,81,18,13,22,20,16,22,19,26,31,42,38,45,1
28.10.2025,2025,sloven,150,Tajfun Sentjur,x,79,65,15,18,23,15,22,17,19,15,33,38,39,34,-1
26.10.2025,2025,sloven,148,KK Triglav Kranj,x,75,83,23,20,22,23,17,20,13,20,43,45,37,33,-1
26.10.2025,2025,sloven,155,Sencur,x,79,67,18,15,23,20,16,18,22,14,33,43,34,36,-1
25.10.2025,2025,sloven,157,Podcetrtek,x,69,80,15,16,14,18,15,26,25,20,31,32,41,45,1
22.10.2025,2025,sloven,164,KK Krka Novo mesto,x,75,81,18,13,22,20,16,22,19,26,31,42,38,45,1
27.10.2025,2025,slovak,172,Spisski Rytieri,Iskra Svit,87,65,22,18,28,8,18,17,19,22,40,36,35,41,-1
27.10.2025,2025,slovak,172,Inter Bratislava,BKM Lucenec,104,79,27,24,29,15,29,22,19,18,51,44,51,37,1
26.10.2025,2025,slovak,173,BC Prievidza,SPU Nitra,73,66,29,8,12,20,14,13,18,25,37,32,27,43,-1
26.10.2025,2025,slovak,156,MBK Handlova,Levice,70,72,19,13,18,20,15,22,18,17,32,38,37,35,-1
26.10.2025,2025,slovak,166,Nitra Blue Wings,BC Komarno,93,63,22,21,20,15,28,9,23,18,43,35,37,41,-1
27.10.2025,2025,slovak,172,Iskra Svit,x,87,65,22,18,28,8,18,17,19,22,40,36,35,41,-1
27.10.2025,2025,slovak,172,BKM Lucenec,x,104,79,27,24,29,15,29,22,19,18,51,44,51,37,1
26.10.2025,2025,slovak,173,SPU Nitra,x,73,66,29,8,12,20,14,13,18,25,37,32,27,43,-1
26.10.2025,2025,slovak,156,Levice,x,70,72,19,13,18,20,15,22,18,17,32,38,37,35,-1
26.10.2025,2025,slovak,166,BC Komarno,x,93,63,22,21,20,15,28,9,23,18,43,35,37,41,-1
28.10.2025,2025,rom,151,Petrolul Ploiesti,SCM Craiova,57,96,24,20,8,27,13,25,12,24,44,35,38,36,-1
26.10.2025,2025,rom,176,Municipal Galati,CSM Targu Mures,83,93,21,27,17,24,20,12,25,30,48,41,32,55,-1
26.10.2025,2025,rom,163,CSM Oradea,CSM Constanta,93,75,30,14,18,21,18,18,27,22,44,39,36,49,1
26.10.2025,2025,rom,161,Rapid Bucuresti,Cluj-Napoca,75,91,18,18,14,29,19,22,24,22,36,43,41,46,1
26.10.2025,2025,rom,156,Valcea,CSU Sibiu,90,64,24,22,17,21,28,5,21,16,46,38,33,37,-1
26.10.2025,2025,rom,157,Voluntari,Arges Pitesti,67,59,17,11,17,19,13,9,20,20,28,36,22,40,-1
28.10.2025,2025,rom,151,SCM Craiova,x,57,96,24,20,8,27,13,25,12,24,44,35,38,36,-1
26.10.2025,2025,rom,176,CSM Targu Mures,x,83,93,21,27,17,24,20,12,25,30,48,41,32,55,-1
26.10.2025,2025,rom,163,CSM Constanta,x,93,75,30,14,18,21,18,18,27,22,44,39,36,49,1
26.10.2025,2025,rom,161,Cluj-Napoca,x,75,91,18,18,14,29,19,22,24,22,36,43,41,46,1
26.10.2025,2025,rom,156,CSU Sibiu,x,90,64,24,22,17,21,28,5,21,16,46,38,33,37,-1
26.10.2025,2025,rom,157,Arges Pitesti,x,67,59,17,11,17,19,13,9,20,20,28,36,22,40,-1
26.10.2025,2025,swit,155,Geneva Lions,Lausanne Basket,88,82,24,18,20,21,16,17,28,26,42,41,33,54,1
26.10.2025,2025,swit,155,Neuchatel,Lugano Tigers,87,84,29,18,16,27,24,15,18,24,47,43,39,42,1
26.10.2025,2025,swit,159,Fribourg Olympic,Sdent BBC Nyon,105,79,21,20,23,19,29,17,32,23,41,42,46,55,1
25.10.2025,2025,swit,156,BBC Monthey,Regio Basel,85,80,18,17,26,12,21,25,20,26,35,38,46,46,1
26.10.2025,2025,swit,155,Lausanne Basket,x,88,82,24,18,20,21,16,17,28,26,42,41,33,54,1
26.10.2025,2025,swit,155,Lugano Tigers,x,87,84,29,18,16,27,24,15,18,24,47,43,39,42,1
26.10.2025,2025,swit,159,Sdent BBC Nyon,x,105,79,21,20,23,19,29,17,32,23,41,42,46,55,1
25.10.2025,2025,swit,156,Regio Basel,x,85,80,18,17,26,12,21,25,20,26,35,38,46,46,1
27.10.2025,2025,tur,170,Galatasaray,Merkezefendi,84,78,19,18,16,20,20,25,29,15,37,36,45,44,1
27.10.2025,2025,tur,166,Mersin SK,Manisa,97,88,29,28,24,17,20,27,24,16,57,41,47,40,1
27.10.2025,2025,tur,171,Darussafaka,Fenerbahce,87,97,29,21,21,27,23,28,14,21,50,48,51,35,1
27.10.2025,2025,tur,167,Bursaspor,Turk Telekom,94,90,23,18,16,17,27,23,28,32,41,33,50,60,1
26.10.2025,2025,tur,163,Bahcesehir Kol.,Buyukcekmece,76,70,20,20,23,18,17,16,16,16,40,41,33,32,-1
26.10.2025,2025,tur,170,Besiktas,Karsiyaka,89,82,26,24,16,23,24,19,23,16,50,39,43,39,-1
26.10.2025,2025,tur,174,Petkim Spor,Anadolu Efes,79,85,19,24,24,23,13,22,23,16,43,47,35,39,-1
26.10.2025,2025,tur,166,Yalovaspor,Tofas,65,77,18,22,17,18,17,14,13,23,40,35,31,36,-1
28.10.2025,2025,tur b,160,iLab Basketbol,MKE Ankaragucu,72,66,10,10,23,15,19,24,20,17,20,38,43,37,-1
27.10.2025,2025,tur b,162,Istanbul Anka Spor,Kapakli Spor,74,88,28,23,16,31,20,15,10,19,51,47,35,29,-1
27.10.2025,2025,tur b,159,Bordo Sportif,Konya BBSK,81,74,20,17,24,15,10,21,27,21,37,39,31,48,-1
27.10.2025,2025,tur b,157,Ankara Kolejliler,Trabzonspor,73,69,9,14,28,25,23,18,13,12,23,53,41,25,-1
26.10.2025,2025,tur b,159,Cayirova,Fenerbahce 2,80,69,21,19,22,20,16,16,21,14,40,42,32,35,-1
26.10.2025,2025,tur b,152,Final Spor,Harem Spor,85,80,19,19,24,23,24,28,18,10,38,47,52,28,1
26.10.2025,2025,tur b,157,Esenler Erokspor,Çağdaş Bodrum Spor,78,77,25,17,28,15,14,24,11,21,42,43,38,32,-1
26.10.2025,2025,tur b,157,Gaziantep,CO Basket,74,79,16,15,19,26,18,21,21,17,31,45,39,38,-1
25.10.2025,2025,tur b,158,OGM Ormanspor,Balikesir,72,86,13,27,20,19,17,19,22,21,40,39,36,43,-1
27.10.2025,2025,tur,170,Merkezefendi,x,84,78,19,18,16,20,20,25,29,15,37,36,45,44,1
27.10.2025,2025,tur,166,Manisa,x,97,88,29,28,24,17,20,27,24,16,57,41,47,40,1
27.10.2025,2025,tur,171,Fenerbahce,x,87,97,29,21,21,27,23,28,14,21,50,48,51,35,1
27.10.2025,2025,tur,167,Turk Telekom,x,94,90,23,18,16,17,27,23,28,32,41,33,50,60,1
26.10.2025,2025,tur,163,Buyukcekmece,x,76,70,20,20,23,18,17,16,16,16,40,41,33,32,-1
26.10.2025,2025,tur,170,Karsiyaka,x,89,82,26,24,16,23,24,19,23,16,50,39,43,39,-1
26.10.2025,2025,tur,174,Anadolu Efes,x,79,85,19,24,24,23,13,22,23,16,43,47,35,39,-1
26.10.2025,2025,tur,166,Tofas,x,65,77,18,22,17,18,17,14,13,23,40,35,31,36,-1
28.10.2025,2025,tur b,160,MKE Ankaragucu,x,72,66,10,10,23,15,19,24,20,17,20,38,43,37,-1
27.10.2025,2025,tur b,162,Kapakli Spor,x,74,88,28,23,16,31,20,15,10,19,51,47,35,29,-1
27.10.2025,2025,tur b,159,Konya BBSK,x,81,74,20,17,24,15,10,21,27,21,37,39,31,48,-1
27.10.2025,2025,tur b,157,Trabzonspor,x,73,69,9,14,28,25,23,18,13,12,23,53,41,25,-1
26.10.2025,2025,tur b,159,Fenerbahce 2,x,80,69,21,19,22,20,16,16,21,14,40,42,32,35,-1
26.10.2025,2025,tur b,152,Harem Spor,x,85,80,19,19,24,23,24,28,18,10,38,47,52,28,1
26.10.2025,2025,tur b,157,Çağdaş Bodrum Spor,x,78,77,25,17,28,15,14,24,11,21,42,43,38,32,-1
26.10.2025,2025,tur b,157,CO Basket,x,74,79,16,15,19,26,18,21,21,17,31,45,39,38,-1
25.10.2025,2025,tur b,158,Balikesir,x,72,86,13,27,20,19,17,19,22,21,40,39,36,43,-1
28.10.2025,2025,ukr,144,Stariy Lutsk,Rivne,60,81,18,15,10,22,9,26,23,18,33,32,35,41,1
25.10.2025,2025,ukr,146,Rivne,Stariy Lutsk,61,52,13,6,14,11,17,23,17,12,19,25,40,29,-1
25.10.2025,2025,ukr,152,Cherkaski Mavpy,Kyiv Basket,72,92,18,29,17,23,13,20,24,20,47,40,33,44,1
25.10.2025,2025,ukr,140,Kryvbas,Goverla,72,71,24,19,12,21,17,13,19,18,43,33,30,37,-1
24.10.2025,2025,ukr,142,Cherkaski Mavpy,Goverla,96,71,24,19,21,20,24,12,27,20,43,41,36,47,1
24.10.2025,2025,ukr,143,Kryvbas,Kyiv Basket,65,75,17,23,14,17,19,23,15,12,40,31,42,27,-1
28.10.2025,2025,ukr,144,Rivne,x,60,81,18,15,10,22,9,26,23,18,33,32,35,41,1
25.10.2025,2025,ukr,146,Stariy Lutsk,x,61,52,13,6,14,11,17,23,17,12,19,25,40,29,-1
25.10.2025,2025,ukr,152,Kyiv Basket,x,72,92,18,29,17,23,13,20,24,20,47,40,33,44,1
25.10.2025,2025,ukr,140,Goverla,x,72,71,24,19,12,21,17,13,19,18,43,33,30,37,-1
24.10.2025,2025,ukr,142,Goverla,x,96,71,24,19,21,20,24,12,27,20,43,41,36,47,1
24.10.2025,2025,ukr,143,Kyiv Basket,x,65,75,17,23,14,17,19,23,15,12,40,31,42,27,-1
28.10.2025,2025,vtb,158,Unics Kazan,MBA Moscow,85,62,18,7,27,23,24,16,16,16,25,50,40,32,-1
27.10.2025,2025,vtb,153,Parma Perm,Samara,92,89,20,18,20,27,28,18,24,26,38,47,46,50,1
27.10.2025,2025,vtb,155,Saratov,Uralmash Ekaterinburg,81,100,24,27,17,28,23,22,17,23,51,45,45,40,1
27.10.2025,2025,vtb,170,CSKA Moscow,Lokomotiv Kuban,92,91,16,22,24,20,21,19,31,30,38,44,40,61,1
26.10.2025,2025,vtb,155,Astana,Zenit Petersburg,64,99,14,25,16,24,9,29,25,21,39,40,38,46,1
24.10.2025,2025,vtb,155,MBA Moscow,Uralmash Ekaterinburg,85,68,20,16,16,12,23,21,26,19,36,28,44,45,1
24.10.2025,2025,vtb,162,Nizhny Novgorod,Lokomotiv Kuban,72,95,19,26,21,18,20,26,12,25,45,39,46,37,1
23.10.2025,2025,vtb,156,CSKA Moscow,Saratov,85,74,23,21,21,24,16,14,25,15,44,45,30,40,-1
23.10.2025,2025,vtb,149,Astana,Enisey,64,70,14,21,12,16,14,24,24,9,35,28,38,33,-1
23.10.2025,2025,vtb,153,Parma Perm,Unics Kazan,74,83,17,26,16,13,20,17,21,27,43,29,37,48,1
28.10.2025,2025,vtb,158,MBA Moscow,x,85,62,18,7,27,23,24,16,16,16,25,50,40,32,-1
27.10.2025,2025,vtb,153,Samara,x,92,89,20,18,20,27,28,18,24,26,38,47,46,50,1
27.10.2025,2025,vtb,155,Uralmash Ekaterinburg,x,81,100,24,27,17,28,23,22,17,23,51,45,45,40,1
27.10.2025,2025,vtb,170,Lokomotiv Kuban,x,92,91,16,22,24,20,21,19,31,30,38,44,40,61,1
26.10.2025,2025,vtb,155,Zenit Petersburg,x,64,99,14,25,16,24,9,29,25,21,39,40,38,46,1
24.10.2025,2025,vtb,155,Uralmash Ekaterinburg,x,85,68,20,16,16,12,23,21,26,19,36,28,44,45,1
24.10.2025,2025,vtb,162,Lokomotiv Kuban,x,72,95,19,26,21,18,20,26,12,25,45,39,46,37,1
23.10.2025,2025,vtb,156,Saratov,x,85,74,23,21,21,24,16,14,25,15,44,45,30,40,-1
23.10.2025,2025,vtb,149,Enisey,x,64,70,14,21,12,16,14,24,24,9,35,28,38,33,-1
23.10.2025,2025,vtb,153,Unics Kazan,Unics Kazan,74,83,17,26,16,13,20,17,21,27,43,29,37,48,1
30.10.2025,2025,kore,153,Anyang JungKwanJang,KoGas,64,97,21,26,12,27,18,25,13,19,47,39,43,32,-1
29.10.2025,2025,kore,157,Seoul Thunders,KCC Egis,73,77,20,22,14,21,13,24,26,10,42,35,37,36,-1
28.10.2025,2025,kore,160,Goyang Sono,Anyang JungKwanJang,83,70,21,18,20,21,19,18,23,13,39,41,37,36,-1
30.10.2025,2025,kore,153,KoGas,x,64,97,21,26,12,27,18,25,13,19,47,39,43,32,-1
29.10.2025,2025,kore,157,KCC Egis,x,73,77,20,22,14,21,13,24,26,10,42,35,37,36,-1
28.10.2025,2025,kore,160,Anyang JungKwanJang,x,83,70,21,18,20,21,19,18,23,13,39,41,37,36,-1
30.10.2025,2025,kazak,,Irbis Almaty,Kaspiy Aktau,65,53,18,15,16,8,18,11,13,19,33,24,29,32,
28.10.2025,2025,kazak,,Astana 2,Tobol Kostanay,70,72,17,18,17,19,18,21,18,14,35,36,39,32,
27.10.2025,2025,kazak,,Almaty,Kaspiy Aktau,70,68,13,21,18,12,25,14,14,21,34,30,39,35,
27.10.2025,2025,kazak,,Astana 2,Tobol Kostanay,77,84,19,26,26,19,15,16,17,23,45,45,31,40,
26.10.2025,2025,kazak,,Almaty,Kaspiy Aktau,76,58,25,10,17,16,20,11,14,21,35,33,31,35,
23.10.2025,2025,kazak,,Pavlodar,Tobol Kostanay,72,111,11,38,26,31,21,23,14,19,49,57,44,33,
22.10.2025,2025,kazak,,Pavlodar,Tobol Kostanay,74,107,24,33,20,24,22,21,8,29,57,44,43,37,
20.10.2025,2025,kazak,,Aktobe,Atyrau,101,94,32,21,17,30,26,21,26,22,53,47,47,48,
20.10.2025,2025,kazak,,Kaspiy Aktau,Astana 2,71,56,19,7,15,16,18,17,19,16,26,31,35,35,
19.10.2025,2025,kazak,,Aktobe,Atyrau,84,89,20,19,22,25,15,27,27,18,39,47,42,45,
19.10.2025,2025,kazak,,Kaspiy Aktau,Astana 2,82,81,24,18,20,23,10,21,28,19,42,43,31,47,
12.10.2025,2025,kazak,,Atyrau,Irbis Almaty,74,67,30,14,9,23,18,12,17,18,44,32,30,35,
11.10.2025,2025,kazak,,Atyrau,Irbis Almaty,75,81,22,31,22,14,21,16,10,20,53,36,37,30,
09.10.2025,2025,kazak,,Tobol Kostanay,Kaspiy Aktau,81,84,23,22,18,14,18,18,22,30,45,32,36,52,
09.10.2025,2025,kazak,,Pavlodar,Almaty,69,82,15,19,17,17,16,28,21,18,34,34,44,39,
08.10.2025,2025,kazak,,Aktobe,Irbis Almaty,62,75,16,18,20,20,11,17,15,20,34,40,28,35,
08.10.2025,2025,kazak,,Tobol Kostanay,Kaspiy Aktau,74,83,20,23,26,19,11,23,17,18,43,45,34,35,
08.10.2025,2025,kazak,,Pavlodar,Almaty,68,89,12,19,17,17,19,32,20,21,31,34,51,41,
07.10.2025,2025,kazak,,Aktobe,Irbis Almaty,81,78,32,19,19,12,18,27,12,20,51,31,45,32,
05.10.2025,2025,kazak,,Astana 2,Almaty,86,90,19,20,15,19,26,32,26,19,39,34,58,45,
04.10.2025,2025,kazak,,Astana 2,Almaty,77,74,22,23,14,17,25,19,16,15,45,31,44,31,
30.10.2025,2025,kazak,,Kaspiy Aktau,x,65,53,18,15,16,8,18,11,13,19,33,24,29,32,
28.10.2025,2025,kazak,,Tobol Kostanay,x,70,72,17,18,17,19,18,21,18,14,35,36,39,32,
27.10.2025,2025,kazak,,Kaspiy Aktau,x,70,68,13,21,18,12,25,14,14,21,34,30,39,35,
27.10.2025,2025,kazak,,Tobol Kostanay,x,77,84,19,26,26,19,15,16,17,23,45,45,31,40,
26.10.2025,2025,kazak,,Kaspiy Aktau,x,76,58,25,10,17,16,20,11,14,21,35,33,31,35,
23.10.2025,2025,kazak,,Tobol Kostanay,x,72,111,11,38,26,31,21,23,14,19,49,57,44,33,
22.10.2025,2025,kazak,,Tobol Kostanay,x,74,107,24,33,20,24,22,21,8,29,57,44,43,37,
20.10.2025,2025,kazak,,Atyrau,x,101,94,32,21,17,30,26,21,26,22,53,47,47,48,
20.10.2025,2025,kazak,,Astana 2,x,71,56,19,7,15,16,18,17,19,16,26,31,35,35,
19.10.2025,2025,kazak,,Atyrau,x,84,89,20,19,22,25,15,27,27,18,39,47,42,45,
19.10.2025,2025,kazak,,Astana 2,x,82,81,24,18,20,23,10,21,28,19,42,43,31,47,
12.10.2025,2025,kazak,,Irbis Almaty,x,74,67,30,14,9,23,18,12,17,18,44,32,30,35,
11.10.2025,2025,kazak,,Irbis Almaty,x,75,81,22,31,22,14,21,16,10,20,53,36,37,30,
09.10.2025,2025,kazak,,Kaspiy Aktau,x,81,84,23,22,18,14,18,18,22,30,45,32,36,52,
09.10.2025,2025,kazak,,Almaty,x,69,82,15,19,17,17,16,28,21,18,34,34,44,39,
08.10.2025,2025,kazak,,Irbis Almaty,x,62,75,16,18,20,20,11,17,15,20,34,40,28,35,
08.10.2025,2025,kazak,,Kaspiy Aktau,x,74,83,20,23,26,19,11,23,17,18,43,45,34,35,
08.10.2025,2025,kazak,,Almaty,x,68,89,12,19,17,17,19,32,20,21,31,34,51,41,
07.10.2025,2025,kazak,,Irbis Almaty,x,81,78,32,19,19,12,18,27,12,20,51,31,45,32,
05.10.2025,2025,kazak,,Almaty,x,86,90,19,20,15,19,26,32,26,19,39,34,58,45,
04.10.2025,2025,kazak,,Almaty,x,77,74,22,23,14,17,25,19,16,15,45,31,44,31,
31.10.2025,2025,arj,166,Obras Sanitarias,Riachuelo,80,84,18,23,17,16,22,31,23,14,41,33,53,37,1
31.10.2025,2025,arj,165,La Union,Union De Santa Fe,90,79,25,17,16,27,22,17,27,18,42,43,39,45,1
30.10.2025,2025,arj,159,Quimsa,Argentino,100,75,28,18,20,29,26,10,26,18,46,49,36,44,1
30.10.2025,2025,arj,154,Ferro,San Lorenzo,73,77,16,21,21,14,11,20,25,22,37,35,31,47,1
30.10.2025,2025,arj,163,Regatas,Obera TC,81,83,24,18,25,27,16,21,16,17,42,52,37,33,-1
29.10.2025,2025,arj,149,San Martin,Union De Santa Fe,65,54,13,12,18,19,16,7,18,16,25,37,23,34,-1
28.10.2025,2025,arj,161,La Union,Obera TC,96,103,27,26,24,27,16,25,29,25,53,51,41,54,1
28.10.2025,2025,arj,157,Riachuelo,Argentino,87,76,22,21,23,15,21,22,21,18,43,38,43,39,1
27.10.2025,2025,arj,159,Platense,Ferro,79,85,13,20,25,25,12,19,29,21,33,50,31,50,1
26.10.2025,2025,arj,160,Boca Juniors,Penarol,83,81,24,15,20,26,20,20,19,20,39,46,40,39,-1
25.10.2025,2025,arj,155,San Lorenzo,Gimnasia,78,74,21,14,21,12,23,22,13,26,35,33,45,39,1
24.10.2025,2025,arj,155,Zarate,Penarol,87,82,21,23,25,20,17,17,24,22,44,45,34,46,1
23.10.2025,2025,arj,163,Obera TC,Gimnasia,76,72,18,20,25,17,22,16,11,19,38,42,38,30,-1
23.10.2025,2025,arj,154,Union De Santa Fe,Platense,103,96,28,19,33,27,14,23,28,27,47,60,37,55,1
22.10.2025,2025,arj,158,Atenas,Instituto de Cordoba,74,87,14,26,23,19,18,21,19,21,40,42,39,40,-1
22.10.2025,2025,arj,162,Riachuelo,Boca Juniors,75,80,20,22,23,23,16,16,16,19,42,46,32,35,-1
22.10.2025,2025,arj,152,Argentino,Penarol,83,85,22,20,23,14,18,22,20,29,42,37,40,49,1
19.10.2025,2025,arj,158,Quimsa,Boca Juniors,97,67,23,18,29,13,20,21,25,15,41,42,41,40,1
19.10.2025,2025,arj,164,Ferro,Obras Sanitarias,85,83,19,24,26,19,21,18,19,22,43,45,39,41,-1
19.10.2025,2025,arj,161,Riachuelo,Regatas,99,58,25,13,27,13,22,14,25,18,38,40,36,43,-1
19.10.2025,2025,arj,152,Argentino,Union De Santa Fe,67,69,25,21,11,19,17,17,14,12,46,30,34,26,-1
18.10.2025,2025,arj,158,Olimpico,Boca Juniors,93,74,22,21,20,23,24,22,27,8,43,43,46,35,1
18.10.2025,2025,arj,160,Zarate,Independiente de Oliva,71,72,25,16,17,18,10,20,19,18,41,35,30,37,-1
17.10.2025,2025,arj,158,Quimsa,Regatas,103,85,27,18,30,19,16,26,30,22,45,49,42,52,1
17.10.2025,2025,arj,157,Argentino,Obera TC,67,76,21,26,16,16,11,20,19,14,47,32,31,33,-1
17.10.2025,2025,arj,161,Ferro,Union De Santa Fe,72,77,17,18,12,20,22,13,21,26,35,32,35,47,1
16.10.2025,2025,arj,158,La Union,Instituto de Cordoba,79,85,28,18,16,27,16,15,19,25,46,43,31,44,-1
16.10.2025,2025,arj,159,Platense,Independiente de Oliva,83,87,23,28,23,22,16,14,21,23,51,45,30,44,-1
15.10.2025,2025,arj,154,Boca Juniors,Union De Santa Fe,99,72,30,22,24,12,24,16,21,22,52,36,40,43,1
15.10.2025,2025,arj,160,Olimpico,Regatas,89,86,24,18,27,16,20,27,18,25,42,43,47,43,1
15.10.2025,2025,arj,154,Penarol,Obera TC,78,97,25,23,15,24,15,25,23,25,48,39,40,48,1
14.10.2025,2025,arj,153,San Martin,Instituto de Cordoba,54,76,17,21,14,28,16,13,7,14,38,42,29,21,-1
14.10.2025,2025,arj,161,Gimnasia,Independiente de Oliva,97,83,23,29,26,14,16,18,32,22,52,40,34,54,1
12.10.2025,2025,arj,151,Boca Juniors,Zarate,88,61,25,9,23,18,28,15,12,19,34,41,43,31,-1
12.10.2025,2025,arj,154,Platense,Penarol,72,75,15,23,15,9,23,25,19,18,38,24,48,37,1
12.10.2025,2025,arj,155,Regatas,Instituto de Cordoba,82,77,29,25,24,24,18,11,11,17,54,48,29,28,-1
12.10.2025,2025,arj,162,Gimnasia,Obras Sanitarias,89,91,23,20,20,18,28,20,18,33,43,38,48,51,1
11.10.2025,2025,arj,161,Independiente de Oliva,Olimpico,104,72,20,15,36,23,26,17,22,17,35,59,43,39,1
11.10.2025,2025,arj,153,Ferro,Penarol,84,82,16,23,23,19,16,15,22,20,39,42,31,42,-1
09.10.2025,2025,arj,157,Union De Santa Fe,San Lorenzo,68,63,16,25,25,14,14,10,13,14,41,39,24,27,-1
09.10.2025,2025,arj,157,Instituto de Cordoba,Olimpico,99,73,33,19,27,18,19,18,20,18,52,45,37,38,-1
09.10.2025,2025,arj,161,Obras Sanitarias,Platense,94,90,27,24,19,25,25,11,9,20,51,44,36,29,-1
08.10.2025,2025,arj,159,Atenas,Boca Juniors,69,81,15,26,18,23,17,17,19,15,41,41,34,34,-1
31.10.2025,2025,arj,166,Riachuelo,x,80,84,18,23,17,16,22,31,23,14,41,33,53,37,1
31.10.2025,2025,arj,165,Union De Santa Fe,x,90,79,25,17,16,27,22,17,27,18,42,43,39,45,1
30.10.2025,2025,arj,159,Argentino,x,100,75,28,18,20,29,26,10,26,18,46,49,36,44,1
30.10.2025,2025,arj,154,San Lorenzo,x,73,77,16,21,21,14,11,20,25,22,37,35,31,47,1
30.10.2025,2025,arj,163,Obera TC,x,81,83,24,18,25,27,16,21,16,17,42,52,37,33,-1
29.10.2025,2025,arj,149,Union De Santa Fe,x,65,54,13,12,18,19,16,7,18,16,25,37,23,34,-1
28.10.2025,2025,arj,161,Obera TC,x,96,103,27,26,24,27,16,25,29,25,53,51,41,54,1
28.10.2025,2025,arj,157,Argentino,x,87,76,22,21,23,15,21,22,21,18,43,38,43,39,1
27.10.2025,2025,arj,159,Ferro,x,79,85,13,20,25,25,12,19,29,21,33,50,31,50,1
26.10.2025,2025,arj,160,Penarol,x,83,81,24,15,20,26,20,20,19,20,39,46,40,39,-1
25.10.2025,2025,arj,155,Gimnasia,x,78,74,21,14,21,12,23,22,13,26,35,33,45,39,1
24.10.2025,2025,arj,155,Penarol,x,87,82,21,23,25,20,17,17,24,22,44,45,34,46,1
23.10.2025,2025,arj,163,Gimnasia,x,76,72,18,20,25,17,22,16,11,19,38,42,38,30,-1
23.10.2025,2025,arj,154,Platense,x,103,96,28,19,33,27,14,23,28,27,47,60,37,55,1
22.10.2025,2025,arj,158,Instituto de Cordoba,x,74,87,14,26,23,19,18,21,19,21,40,42,39,40,-1
22.10.2025,2025,arj,162,Boca Juniors,x,75,80,20,22,23,23,16,16,16,19,42,46,32,35,-1
22.10.2025,2025,arj,152,Penarol,x,83,85,22,20,23,14,18,22,20,29,42,37,40,49,1
19.10.2025,2025,arj,158,Boca Juniors,x,97,67,23,18,29,13,20,21,25,15,41,42,41,40,1
19.10.2025,2025,arj,164,Obras Sanitarias,x,85,83,19,24,26,19,21,18,19,22,43,45,39,41,-1
19.10.2025,2025,arj,161,Regatas,x,99,58,25,13,27,13,22,14,25,18,38,40,36,43,-1
19.10.2025,2025,arj,152,Union De Santa Fe,x,67,69,25,21,11,19,17,17,14,12,46,30,34,26,-1
18.10.2025,2025,arj,158,Boca Juniors,x,93,74,22,21,20,23,24,22,27,8,43,43,46,35,1
18.10.2025,2025,arj,160,Independiente de Oliva,x,71,72,25,16,17,18,10,20,19,18,41,35,30,37,-1
17.10.2025,2025,arj,158,Regatas,x,103,85,27,18,30,19,16,26,30,22,45,49,42,52,1
17.10.2025,2025,arj,157,Obera TC,x,67,76,21,26,16,16,11,20,19,14,47,32,31,33,-1
17.10.2025,2025,arj,161,Union De Santa Fe,x,72,77,17,18,12,20,22,13,21,26,35,32,35,47,1
16.10.2025,2025,arj,158,Instituto de Cordoba,x,79,85,28,18,16,27,16,15,19,25,46,43,31,44,-1
16.10.2025,2025,arj,159,Independiente de Oliva,x,83,87,23,28,23,22,16,14,21,23,51,45,30,44,-1
15.10.2025,2025,arj,154,Union De Santa Fe,x,99,72,30,22,24,12,24,16,21,22,52,36,40,43,1
15.10.2025,2025,arj,160,Regatas,x,89,86,24,18,27,16,20,27,18,25,42,43,47,43,1
15.10.2025,2025,arj,154,Obera TC,x,78,97,25,23,15,24,15,25,23,25,48,39,40,48,1
14.10.2025,2025,arj,153,Instituto de Cordoba,x,54,76,17,21,14,28,16,13,7,14,38,42,29,21,-1
14.10.2025,2025,arj,161,Independiente de Oliva,x,97,83,23,29,26,14,16,18,32,22,52,40,34,54,1
12.10.2025,2025,arj,151,Zarate,x,88,61,25,9,23,18,28,15,12,19,34,41,43,31,-1
12.10.2025,2025,arj,154,Penarol,x,72,75,15,23,15,9,23,25,19,18,38,24,48,37,1
12.10.2025,2025,arj,155,Instituto de Cordoba,x,82,77,29,25,24,24,18,11,11,17,54,48,29,28,-1
12.10.2025,2025,arj,162,Obras Sanitarias,x,89,91,23,20,20,18,28,20,18,33,43,38,48,51,1
11.10.2025,2025,arj,161,Olimpico,x,104,72,20,15,36,23,26,17,22,17,35,59,43,39,1
11.10.2025,2025,arj,153,Penarol,x,84,82,16,23,23,19,16,15,22,20,39,42,31,42,-1
09.10.2025,2025,arj,157,San Lorenzo,x,68,63,16,25,25,14,14,10,13,14,41,39,24,27,-1
09.10.2025,2025,arj,157,Olimpico,x,99,73,33,19,27,18,19,18,20,18,52,45,37,38,-1
09.10.2025,2025,arj,161,Platense,x,94,90,27,24,19,25,25,11,9,20,51,44,36,29,-1
08.10.2025,2025,arj,159,Boca Juniors,x,69,81,15,26,18,23,17,17,19,15,41,41,34,34,-1
31.10.2025,2025,bre,152,Sao Paulo,Paulistano,86,84,24,27,22,19,16,16,24,22,51,41,32,46,1
31.10.2025,2025,bre,155,Unifacisa,Botafogo,90,74,27,12,16,26,29,14,18,22,39,42,43,40,1
30.10.2025,2025,bre,145,Pinheiros,Minas,67,77,17,18,12,26,20,17,18,16,35,38,37,34,-1
30.10.2025,2025,bre,148,Cearense,Flamengo,56,78,23,21,11,25,9,14,13,18,44,36,23,31,-1
29.10.2025,2025,bre,161,Franca,Pato,93,70,19,21,27,14,26,14,21,21,40,41,40,42,1
29.10.2025,2025,bre,148,Paulistano,Bauru,79,83,19,17,16,23,24,22,20,21,36,39,46,41,1
28.10.2025,2025,bre,149,Cearense,Botafogo,52,77,10,17,17,20,11,22,14,18,27,37,33,32,-1
26.10.2025,2025,bre,156,Sao Paulo,Bauru,78,68,19,22,17,21,23,16,19,9,41,38,39,28,-1
26.10.2025,2025,bre,153,Brasilia,Mogi,86,80,18,14,32,25,18,24,18,17,32,57,42,35,1
26.10.2025,2025,bre,148,Flamengo,Pinheiros,66,61,16,22,16,15,12,15,22,9,38,31,27,31,-1
26.10.2025,2025,bre,156,Pato,Unifacisa,85,77,17,22,21,9,14,27,33,19,39,30,41,52,1
25.10.2025,2025,bre,155,Flamengo,Corinthians Paulista,70,83,25,26,18,19,13,18,14,20,51,37,31,34,-1
25.10.2025,2025,bre,148,Paulistano,Franca,90,100,30,17,26,31,12,29,22,23,47,57,41,45,1
25.10.2025,2025,bre,151,Minas,Mogi,91,61,21,14,17,24,24,10,29,13,35,41,34,42,1
24.10.2025,2025,bre,144,Botafogo,Pinheiros,67,80,13,14,8,21,31,28,15,17,27,29,59,32,1
24.10.2025,2025,bre,156,Brasilia,Sao Jose,81,76,25,22,16,17,13,20,27,17,47,33,33,44,-1
24.10.2025,2025,bre,149,Caxias do Sul,Uniao Corinthians,77,89,18,23,20,25,13,20,26,21,41,45,33,47,1
23.10.2025,2025,bre,158,Botafogo,Corinthians Paulista,58,73,15,15,15,26,11,25,17,7,30,41,36,24,-1
23.10.2025,2025,bre,158,Sao Paulo,Franca,82,66,21,14,16,22,22,18,23,12,35,38,40,35,-1
23.10.2025,2025,bre,153,Pato,Cearense,89,60,23,11,25,15,21,19,20,15,34,40,40,35,-1
22.10.2025,2025,bre,143,Vasco,Pinheiros,62,65,10,10,16,17,14,11,22,27,20,33,25,49,1
22.10.2025,2025,bre,149,Minas,Sao Jose,91,64,16,22,28,14,25,17,22,11,38,42,42,33,1
19.10.2025,2025,bre,158,Corinthians Paulista,Sao Paulo,80,82,15,20,26,20,20,19,19,23,35,46,39,42,1
19.10.2025,2025,bre,144,Mogi,Flamengo,66,114,20,25,14,30,5,29,27,30,45,44,34,57,1
19.10.2025,2025,bre,150,Cearense,Uniao Corinthians,70,79,19,16,11,24,18,22,22,17,35,35,40,39,1
19.10.2025,2025,bre,154,Unifacisa,Caxias do Sul,63,81,12,21,15,18,11,22,25,20,33,33,33,45,1
18.10.2025,2025,bre,161,Franca,Brasilia,79,74,25,17,17,14,23,20,14,23,42,31,43,37,-1
18.10.2025,2025,bre,145,Mogi,Vasco,66,65,12,12,16,16,20,14,18,23,24,32,34,41,1
18.10.2025,2025,bre,156,Bauru,Minas,81,82,12,9,14,23,13,22,32,17,21,37,35,49,1
18.10.2025,2025,bre,154,Pato,Sao Paulo,81,88,30,23,16,22,25,19,10,24,53,38,44,34,1
18.10.2025,2025,bre,151,Sao Jose,Flamengo,63,71,20,18,8,18,14,26,21,9,38,26,40,30,-1
16.10.2025,2025,bre,159,Franca,Minas,82,76,20,21,20,20,17,10,25,25,41,40,27,50,-1
16.10.2025,2025,bre,152,Bauru,Brasilia,93,91,28,19,22,20,20,24,23,28,47,42,44,51,1
16.10.2025,2025,bre,148,Cearense,Caxias do Sul,76,68,15,18,18,17,25,13,18,20,33,35,38,38,1
16.10.2025,2025,bre,151,Sao Jose,Vasco,59,68,13,19,18,14,15,13,13,22,32,32,28,35,-1
16.10.2025,2025,bre,155,Unifacisa,Uniao Corinthians,83,71,14,32,25,12,21,18,23,9,46,37,39,32,-1
15.10.2025,2025,bre,153,Corinthians Paulista,Pato,86,89,25,22,16,25,22,19,23,23,47,41,41,46,1
15.10.2025,2025,bre,154,Mogi,Botafogo,70,72,12,17,17,12,21,18,15,18,29,29,39,33,-1
15.10.2025,2025,bre,146,Paulistano,Pinheiros,80,62,29,13,24,13,13,18,14,18,42,37,31,32,-1
13.10.2025,2025,bre,154,Pinheiros,Pato,68,67,24,23,16,12,15,15,13,17,47,28,30,30,-1
13.10.2025,2025,bre,158,Sao Jose,Botafogo,70,81,18,32,17,21,16,17,19,11,50,38,33,30,-1
13.10.2025,2025,bre,147,Mogi,Paulistano,72,67,19,17,21,21,18,15,14,14,36,42,33,28,-1
13.10.2025,2025,bre,160,Minas,Brasilia,74,66,16,15,18,18,17,13,23,20,31,36,30,43,-1
12.10.2025,2025,bre,152,Vasco,Flamengo,50,59,14,11,8,14,12,20,16,14,25,22,32,30,-1
31.10.2025,2025,bre,152,Paulistano,x,86,84,24,27,22,19,16,16,24,22,51,41,32,46,1
31.10.2025,2025,bre,155,Botafogo,x,90,74,27,12,16,26,29,14,18,22,39,42,43,40,1
30.10.2025,2025,bre,145,Minas,x,67,77,17,18,12,26,20,17,18,16,35,38,37,34,-1
30.10.2025,2025,bre,148,Flamengo,x,56,78,23,21,11,25,9,14,13,18,44,36,23,31,-1
29.10.2025,2025,bre,161,Pato,x,93,70,19,21,27,14,26,14,21,21,40,41,40,42,1
29.10.2025,2025,bre,148,Bauru,x,79,83,19,17,16,23,24,22,20,21,36,39,46,41,1
28.10.2025,2025,bre,149,Botafogo,x,52,77,10,17,17,20,11,22,14,18,27,37,33,32,-1
26.10.2025,2025,bre,156,Bauru,x,78,68,19,22,17,21,23,16,19,9,41,38,39,28,-1
26.10.2025,2025,bre,153,Mogi,x,86,80,18,14,32,25,18,24,18,17,32,57,42,35,1
26.10.2025,2025,bre,148,Pinheiros,x,66,61,16,22,16,15,12,15,22,9,38,31,27,31,-1
26.10.2025,2025,bre,156,Unifacisa,x,85,77,17,22,21,9,14,27,33,19,39,30,41,52,1
25.10.2025,2025,bre,155,Corinthians Paulista,x,70,83,25,26,18,19,13,18,14,20,51,37,31,34,-1
25.10.2025,2025,bre,148,Franca,x,90,100,30,17,26,31,12,29,22,23,47,57,41,45,1
25.10.2025,2025,bre,151,Mogi,x,91,61,21,14,17,24,24,10,29,13,35,41,34,42,1
24.10.2025,2025,bre,144,Pinheiros,x,67,80,13,14,8,21,31,28,15,17,27,29,59,32,1
24.10.2025,2025,bre,156,Sao Jose,x,81,76,25,22,16,17,13,20,27,17,47,33,33,44,-1
24.10.2025,2025,bre,149,Uniao Corinthians,x,77,89,18,23,20,25,13,20,26,21,41,45,33,47,1
23.10.2025,2025,bre,158,Corinthians Paulista,x,58,73,15,15,15,26,11,25,17,7,30,41,36,24,-1
23.10.2025,2025,bre,158,Franca,x,82,66,21,14,16,22,22,18,23,12,35,38,40,35,-1
23.10.2025,2025,bre,153,Cearense,x,89,60,23,11,25,15,21,19,20,15,34,40,40,35,-1
22.10.2025,2025,bre,143,Pinheiros,x,62,65,10,10,16,17,14,11,22,27,20,33,25,49,1
22.10.2025,2025,bre,149,Sao Jose,x,91,64,16,22,28,14,25,17,22,11,38,42,42,33,1
19.10.2025,2025,bre,158,Sao Paulo,x,80,82,15,20,26,20,20,19,19,23,35,46,39,42,1
19.10.2025,2025,bre,144,Flamengo,x,66,114,20,25,14,30,5,29,27,30,45,44,34,57,1
19.10.2025,2025,bre,150,Uniao Corinthians,x,70,79,19,16,11,24,18,22,22,17,35,35,40,39,1
19.10.2025,2025,bre,154,Caxias do Sul,x,63,81,12,21,15,18,11,22,25,20,33,33,33,45,1
18.10.2025,2025,bre,161,Brasilia,x,79,74,25,17,17,14,23,20,14,23,42,31,43,37,-1
18.10.2025,2025,bre,145,Vasco,x,66,65,12,12,16,16,20,14,18,23,24,32,34,41,1
18.10.2025,2025,bre,156,Minas,x,81,82,12,9,14,23,13,22,32,17,21,37,35,49,1
18.10.2025,2025,bre,154,Sao Paulo,x,81,88,30,23,16,22,25,19,10,24,53,38,44,34,1
18.10.2025,2025,bre,151,Flamengo,x,63,71,20,18,8,18,14,26,21,9,38,26,40,30,-1
16.10.2025,2025,bre,159,Minas,x,82,76,20,21,20,20,17,10,25,25,41,40,27,50,-1
16.10.2025,2025,bre,152,Brasilia,x,93,91,28,19,22,20,20,24,23,28,47,42,44,51,1
16.10.2025,2025,bre,148,Caxias do Sul,x,76,68,15,18,18,17,25,13,18,20,33,35,38,38,1
16.10.2025,2025,bre,151,Vasco,x,59,68,13,19,18,14,15,13,13,22,32,32,28,35,-1
16.10.2025,2025,bre,155,Uniao Corinthians,x,83,71,14,32,25,12,21,18,23,9,46,37,39,32,-1
15.10.2025,2025,bre,153,Pato,x,86,89,25,22,16,25,22,19,23,23,47,41,41,46,1
15.10.2025,2025,bre,154,Botafogo,x,70,72,12,17,17,12,21,18,15,18,29,29,39,33,-1
15.10.2025,2025,bre,146,Pinheiros,x,80,62,29,13,24,13,13,18,14,18,42,37,31,32,-1
13.10.2025,2025,bre,154,Pato,x,68,67,24,23,16,12,15,15,13,17,47,28,30,30,-1
13.10.2025,2025,bre,158,Botafogo,x,70,81,18,32,17,21,16,17,19,11,50,38,33,30,-1
13.10.2025,2025,bre,147,Paulistano,x,72,67,19,17,21,21,18,15,14,14,36,42,33,28,-1
13.10.2025,2025,bre,160,Brasilia,x,74,66,16,15,18,18,17,13,23,20,31,36,30,43,-1
12.10.2025,2025,bre,152,Flamengo,x,50,59,14,11,8,14,12,20,16,14,25,22,32,30,-1
01.11.2025,2025,avst,180,Perth,Illawarra Hawks,113,105,39,31,23,22,27,30,24,22,70,45,57,46,1
01.11.2025,2025,avst,164,Tasmania JackJumpers,South East Melbourne,77,79,19,19,23,16,15,20,20,24,38,39,35,44,-1
31.10.2025,2025,avst,180,Melbourne United,Sydney,87,83,21,20,25,23,20,21,21,19,41,48,41,40,-1
01.11.2025,2025,avst,180,Illawarra Hawks,x,113,105,39,31,23,22,27,30,24,22,70,45,57,46,1
01.11.2025,2025,avst,164,South East Melbourne,x,77,79,19,19,23,16,15,20,20,24,38,39,35,44,-1
31.10.2025,2025,avst,180,Sydney,x,87,83,21,20,25,23,20,21,21,19,41,48,41,40,-1
01.11.2025,2025,kore,155,KCC Egis,KoGas,58,80,14,14,16,17,9,21,19,28,28,33,30,47,-1
01.11.2025,2025,kore,157,LG Sakers,Seoul Knights,66,72,14,20,22,20,22,15,8,17,34,42,37,25,-1
31.10.2025,2025,kore,156,Goyang Sono,Suwon KT,61,69,16,20,21,17,14,12,10,20,36,38,26,30,-1
31.10.2025,2025,kore,162,Seoul Thunders,Mobis Phoebus,80,83,19,14,21,12,18,23,16,25,33,33,41,41,1
01.11.2025,2025,kore,155,KoGas,x,58,80,14,14,16,17,9,21,19,28,28,33,30,47,-1
01.11.2025,2025,kore,157,Seoul Knights,x,66,72,14,20,22,20,22,15,8,17,34,42,37,25,-1
31.10.2025,2025,kore,156,Suwon KT,x,61,69,16,20,21,17,14,12,10,20,36,38,26,30,-1
31.10.2025,2025,kore,162,Mobis Phoebus,x,80,83,19,14,21,12,18,23,16,25,33,33,41,41,1
30.10.2025,2025,cek,169,Decin,Nymburk,105,88,24,24,23,23,28,20,30,21,48,46,48,51,1
30.10.2025,2025,cek,169,Jindrichuv Hradec,NH Ostrava,87,90,26,26,26,22,17,24,18,18,52,48,41,36,-1
30.10.2025,2025,cek,169,Olomoucko,Opava,83,87,21,19,17,32,12,12,25,12,40,49,24,37,-1
30.10.2025,2025,cek,174,Srsni Pisek,Pardubice,76,75,20,28,21,10,17,16,18,21,48,31,33,39,-1
30.10.2025,2025,cek,158,USK Prague,Brno,67,87,19,29,19,19,14,21,15,18,48,38,35,33,-1
30.10.2025,2025,cek,156,Slavia Prague,Usti n. Labem,79,86,18,17,16,19,21,21,24,29,35,35,42,53,1
30.10.2025,2025,cek,169,Nymburk,x,105,88,24,24,23,23,28,20,30,21,48,46,48,51,1
30.10.2025,2025,cek,169,NH Ostrava,x,87,90,26,26,26,22,17,24,18,18,52,48,41,36,-1
30.10.2025,2025,cek,169,Opava,x,83,87,21,19,17,32,12,12,25,12,40,49,24,37,-1
30.10.2025,2025,cek,174,Pardubice,x,76,75,20,28,21,10,17,16,18,21,48,31,33,39,-1
30.10.2025,2025,cek,158,Brno,x,67,87,19,29,19,19,14,21,15,18,48,38,35,33,-1
30.10.2025,2025,cek,156,Usti n. Labem,x,79,86,18,17,16,19,21,21,24,29,35,35,42,53,1
28.10.2025,2025,lat lkl,175,Nevezis,Jonava,93,105,22,30,22,21,19,28,30,26,52,43,47,56,1
27.10.2025,2025,lat lkl,168,Mazeikiai,Neptunas,107,96,28,22,20,20,29,25,30,29,50,40,54,59,1
27.10.2025,2025,lat lkl,162,BC Wolves,Zalgiris Kaunas,100,82,20,20,23,18,32,14,25,30,40,41,46,55,1
31.10.2025,2025,lat nkl,157,BC Olimpas Palanga,Jurbarkas,74,79,16,17,16,23,24,17,18,22,33,39,41,40,1
31.10.2025,2025,lat nkl,164,Kretinga,Alytaus Alytus,71,79,20,17,15,21,21,18,15,23,37,36,39,38,-1
31.10.2025,2025,lat nkl,168,Rytas 2,Plunges Olimpas,82,74,19,25,24,14,18,20,21,15,44,38,38,36,-1
31.10.2025,2025,lat nkl,165,Ukmerges Stekas,Vilkaviskis,69,77,7,22,24,17,17,26,21,12,29,41,43,33,-1
31.10.2025,2025,lat nkl,174,Delikatesas Joniskis,Vytis VDU,65,94,13,28,14,18,19,30,19,18,41,32,49,37,-1
31.10.2025,2025,lat nkl,155,Omega-Tauras,Neptunas 2,72,76,26,15,15,16,12,23,19,22,41,31,35,41,-1
31.10.2025,2025,lat nkl,158,Suduva-Mantinga,Zalgiris Kaunas 2,79,88,22,22,13,28,16,20,28,18,44,41,36,46,1
31.10.2025,2025,lat nkl,162,Telsiai,Silute,83,78,17,21,22,9,24,20,20,28,38,31,44,48,1
28.10.2025,2025,lat lkl,175,Jonava,x,93,105,22,30,22,21,19,28,30,26,52,43,47,56,1
27.10.2025,2025,lat lkl,168,Neptunas,x,107,96,28,22,20,20,29,25,30,29,50,40,54,59,1
27.10.2025,2025,lat lkl,162,Zalgiris Kaunas,x,100,82,20,20,23,18,32,14,25,30,40,41,46,55,1
31.10.2025,2025,lat nkl,157,Jurbarkas,x,74,79,16,17,16,23,24,17,18,22,33,39,41,40,1
31.10.2025,2025,lat nkl,164,Alytaus Alytus,x,71,79,20,17,15,21,21,18,15,23,37,36,39,38,-1
31.10.2025,2025,lat nkl,168,Plunges Olimpas,x,82,74,19,25,24,14,18,20,21,15,44,38,38,36,-1
31.10.2025,2025,lat nkl,165,Vilkaviskis,x,69,77,7,22,24,17,17,26,21,12,29,41,43,33,-1
31.10.2025,2025,lat nkl,174,Vytis VDU,x,65,94,13,28,14,18,19,30,19,18,41,32,49,37,-1
31.10.2025,2025,lat nkl,155,Neptunas 2,x,72,76,26,15,15,16,12,23,19,22,41,31,35,41,-1
31.10.2025,2025,lat nkl,158,Zalgiris Kaunas 2,x,79,88,22,22,13,28,16,20,28,18,44,41,36,46,1
31.10.2025,2025,lat nkl,162,Silute,x,83,78,17,21,22,9,24,20,20,28,38,31,44,48,1
03.11.2025,2025,kore,155,KCC Egis,Anyang JungKwanJang,102,71,26,13,27,23,24,19,25,16,39,50,43,41,1
03.11.2025,2025,kore,152,KoGas,Seoul Knights,91,76,25,20,19,25,26,23,21,8,45,44,49,29,1
03.11.2025,2025,kore,157,LG Sakers,Mobis Phoebus,73,78,18,23,25,22,15,22,15,11,41,47,37,26,-1
02.11.2025,2025,kore,155,Seoul Thunders,Goyang Sono,78,76,23,26,14,16,17,19,24,15,49,30,36,39,-1
02.11.2025,2025,kore,160,Mobis Phoebus,Anyang JungKwanJang,71,72,22,16,15,15,19,22,15,19,38,30,41,34,-1
02.11.2025,2025,kore,154,Suwon KT,Wonju DB,80,78,18,25,24,23,21,17,17,13,43,47,38,30,-1
03.11.2025,2025,kore,155,Anyang JungKwanJang,x,102,71,26,13,27,23,24,19,25,16,39,50,43,41,1
03.11.2025,2025,kore,152,Seoul Knights,x,91,76,25,20,19,25,26,23,21,8,45,44,49,29,1
03.11.2025,2025,kore,157,Mobis Phoebus,x,73,78,18,23,25,22,15,22,15,11,41,47,37,26,-1
02.11.2025,2025,kore,155,Goyang Sono,x,78,76,23,26,14,16,17,19,24,15,49,30,36,39,-1
02.11.2025,2025,kore,160,Anyang JungKwanJang,x,71,72,22,16,15,15,19,22,15,19,38,30,41,34,-1
02.11.2025,2025,kore,154,Wonju DB,x,80,78,18,25,24,23,21,17,17,13,43,47,38,30,-1
30.10.2025,2025,aba 2,153,Borac Banja Luka,GKK Sibenka,59,73,10,25,18,14,19,19,12,15,35,32,38,27,-1
30.10.2025,2025,aba 2,165,Pelister,Joker,77,81,20,17,18,18,16,25,23,21,37,36,41,44,1
28.10.2025,2025,aba 2,158,Siroki Brijeg,Podgorica,87,93,17,21,22,19,19,23,17,12,38,41,42,29,-1
28.10.2025,2025,aba 2,161,Ilirija,Zlatibor,69,58,22,8,14,15,17,20,16,15,30,29,37,31,-1
30.10.2025,2025,aba 2,153,GKK Sibenka,x,59,73,10,25,18,14,19,19,12,15,35,32,38,27,-1
30.10.2025,2025,aba 2,165,Joker,x,77,81,20,17,18,18,16,25,23,21,37,36,41,44,1
28.10.2025,2025,aba 2,158,Podgorica,x,87,93,17,21,22,19,19,23,17,12,38,41,42,29,-1
28.10.2025,2025,aba 2,161,Zlatibor,x,69,58,22,8,14,15,17,20,16,15,30,29,37,31,-1
03.11.2025,2025,aba,160,Buducnost,Mega Basket,77,69,15,14,25,19,16,24,21,12,29,44,40,33,-1
02.11.2025,2025,aba,164,Studentski Centar,Dubai,86,87,16,22,20,23,26,19,24,23,38,43,45,47,1
02.11.2025,2025,aba,154,KK Krka Novo mesto,Zadar,73,81,27,22,20,16,10,19,16,24,49,36,29,40,-1
01.11.2025,2025,aba,156,Igokea,Borac,72,79,18,27,21,18,15,13,18,21,45,39,28,39,-1
28.10.2025,2025,aba,160,Studentski Centar,FMP Beograd,82,76,21,16,19,28,20,19,22,13,37,47,39,35,-1
03.11.2025,2025,aba,160,Mega Basket,x,77,69,15,14,25,19,16,24,21,12,29,44,40,33,-1
02.11.2025,2025,aba,164,Dubai,x,86,87,16,22,20,23,26,19,24,23,38,43,45,47,1
02.11.2025,2025,aba,154,Zadar,x,73,81,27,22,20,16,10,19,16,24,49,36,29,40,-1
01.11.2025,2025,aba,156,Borac,x,72,79,18,27,21,18,15,13,18,21,45,39,28,39,-1
28.10.2025,2025,aba,160,FMP Beograd,x,82,76,21,16,19,28,20,19,22,13,37,47,39,35,-1
03.11.2025,2025,avst,167,Sydney,Tasmania JackJumpers,88,60,27,19,14,14,26,18,21,9,46,28,44,30,-1
03.11.2025,2025,avst,177,South East Melbourne,Perth,100,76,35,23,19,21,27,16,19,16,58,40,43,35,-1
02.11.2025,2025,avst,174,Cairns Taipans,Brisbane Bullets,88,92,18,23,26,18,29,23,15,28,41,44,52,43,1
02.11.2025,2025,avst,172,New Zealand Breakers,Adelaide,109,82,33,19,19,20,34,19,23,24,52,39,53,47,1
03.11.2025,2025,avst,167,Tasmania JackJumpers,x,88,60,27,19,14,14,26,18,21,9,46,28,44,30,-1
03.11.2025,2025,avst,177,Perth,x,100,76,35,23,19,21,27,16,19,16,58,40,43,35,-1
02.11.2025,2025,avst,174,Brisbane Bullets,x,88,92,18,23,26,18,29,23,15,28,41,44,52,43,1
02.11.2025,2025,avst,172,Adelaide,x,109,82,33,19,19,20,34,19,23,24,52,39,53,47,1
02.11.2025,2025,sloven,156,Tajfun Sentjur,Sencur,80,69,20,17,21,9,20,17,19,26,37,30,37,45,1
02.11.2025,2025,sloven,148,KK Triglav Kranj,LTH Castings,86,72,18,16,19,14,23,14,26,28,34,33,37,54,1
02.11.2025,2025,sloven,151,Helios Domzale,Ilirija,90,68,23,23,18,19,30,10,19,16,46,37,40,35,-1
30.10.2025,2025,sloven,158,KK Krka Novo mesto,Zlatorog Lasko,95,74,26,18,21,22,22,15,26,19,44,43,37,45,1
02.11.2025,2025,sloven,156,Sencur,x,80,69,20,17,21,9,20,17,19,26,37,30,37,45,1
02.11.2025,2025,sloven,148,LTH Castings,x,86,72,18,16,19,14,23,14,26,28,34,33,37,54,1
02.11.2025,2025,sloven,151,Ilirija,x,90,68,23,23,18,19,30,10,19,16,46,37,40,35,-1
30.10.2025,2025,sloven,158,Zlatorog Lasko,x,95,74,26,18,21,22,22,15,26,19,44,43,37,45,1
03.11.2025,2025,cro,164,Dinamo Zagreb,Cedevita Junior,69,92,22,14,9,30,15,25,23,23,36,39,40,46,1
02.11.2025,2025,cro,160,Alkar,Split,57,80,25,12,8,27,18,18,6,23,37,35,36,29,-1
02.11.2025,2025,cro,160,Zabok,Cibona,80,79,21,20,15,24,27,12,17,23,41,39,39,40,-1
02.11.2025,2025,cro,158,Dubrava,Osijek,84,70,24,14,17,15,19,17,24,24,38,32,36,48,1
30.10.2025,2025,cro,156,Split,Zadar,61,78,17,20,18,18,16,18,10,22,37,36,34,32,-1
30.10.2025,2025,cro,157,Dubrovnik,Dinamo Zagreb,97,81,17,20,25,25,27,21,28,15,37,50,48,43,1
30.10.2025,2025,cro,158,Cibona,Alkar,84,75,25,17,18,18,20,20,21,20,42,36,40,41,1
30.10.2025,2025,cro,160,Osijek,Zabok,75,73,17,19,25,22,21,12,12,20,36,47,33,32,-1
29.10.2025,2025,cro,158,Kvarner,Dubrava,98,70,20,20,29,18,25,24,24,8,40,47,49,32,1
03.11.2025,2025,cro,164,Cedevita Junior,x,69,92,22,14,9,30,15,25,23,23,36,39,40,46,1
02.11.2025,2025,cro,160,Split,x,57,80,25,12,8,27,18,18,6,23,37,35,36,29,-1
02.11.2025,2025,cro,160,Cibona,x,80,79,21,20,15,24,27,12,17,23,41,39,39,40,-1
02.11.2025,2025,cro,158,Osijek,x,84,70,24,14,17,15,19,17,24,24,38,32,36,48,1
30.10.2025,2025,cro,156,Zadar,x,61,78,17,20,18,18,16,18,10,22,37,36,34,32,-1
30.10.2025,2025,cro,157,Dinamo Zagreb,x,97,81,17,20,25,25,27,21,28,15,37,50,48,43,1
30.10.2025,2025,cro,158,Alkar,x,84,75,25,17,18,18,20,20,21,20,42,36,40,41,1
30.10.2025,2025,cro,160,Zabok,x,75,73,17,19,25,22,21,12,12,20,36,47,33,32,-1
29.10.2025,2025,cro,158,Dubrava,x,98,70,20,20,29,18,25,24,24,8,40,47,49,32,1
23.10.2025,2025,vtb,153,Unics Kazan,Unics Kazan,74,83,17,26,16,13,20,17,21,27,43,29,37,48,1
03.11.2025,2025,vtb,151,MBA Moscow,Parma Perm,58,63,21,19,12,12,18,15,7,17,40,24,33,24,-1
03.11.2025,2025,vtb,167,Lokomotiv Kuban,Zenit Petersburg,71,77,15,18,22,20,21,20,13,19,33,42,41,32,-1
03.11.2025,2025,vtb,152,Enisey,Samara,58,73,12,20,17,15,23,16,6,22,32,32,39,28,-1
02.11.2025,2025,vtb,159,CSKA Moscow,Nizhny Novgorod,91,65,31,21,21,20,20,11,19,13,52,41,31,32,-1
31.10.2025,2025,vtb,161,Unics Kazan,Uralmash Ekaterinburg,85,75,24,19,21,13,22,25,18,18,43,34,47,36,1
30.10.2025,2025,vtb,162,Zenit Petersburg,Samara,92,61,23,13,19,15,22,18,28,15,36,34,40,43,1
30.10.2025,2025,vtb,150,Saratov,Astana,88,81,17,18,24,17,23,17,24,29,35,41,40,53,1
30.10.2025,2025,vtb,149,Enisey,Nizhny Novgorod,79,77,18,17,23,26,14,14,24,20,35,49,28,44,-1
23.10.2025,2025,vtb,153,Unics Kazan,x,74,83,17,26,16,13,20,17,21,27,43,29,37,48,1
03.11.2025,2025,vtb,151,Parma Perm,x,58,63,21,19,12,12,18,15,7,17,40,24,33,24,-1
03.11.2025,2025,vtb,167,Zenit Petersburg,x,71,77,15,18,22,20,21,20,13,19,33,42,41,32,-1
03.11.2025,2025,vtb,152,Samara,x,58,73,12,20,17,15,23,16,6,22,32,32,39,28,-1
02.11.2025,2025,vtb,159,Nizhny Novgorod,x,91,65,31,21,21,20,20,11,19,13,52,41,31,32,-1
31.10.2025,2025,vtb,161,Uralmash Ekaterinburg,x,85,75,24,19,21,13,22,25,18,18,43,34,47,36,1
30.10.2025,2025,vtb,162,Samara,x,92,61,23,13,19,15,22,18,28,15,36,34,40,43,1
30.10.2025,2025,vtb,150,Astana,x,88,81,17,18,24,17,23,17,24,29,35,41,40,53,1
30.10.2025,2025,vtb,149,Nizhny Novgorod,x,79,77,18,17,23,26,14,14,24,20,35,49,28,44,-1
03.11.2025,2025,aus,157,Vienna Basket,Klosterneuburg Dukes,81,85,18,20,23,19,15,27,25,19,38,42,42,44,1
03.11.2025,2025,aus,157,Furstenfeld,Kapfenberg Bulls,63,100,15,26,16,21,17,24,15,29,41,37,41,44,1
02.11.2025,2025,aus,155,BBC Nord,Traiskirchen Lions,80,76,22,24,14,17,20,13,24,22,46,31,33,46,1
02.11.2025,2025,aus,162,Wels,Swans Gmunden,89,87,23,23,25,22,24,26,17,16,46,47,50,33,1
31.10.2025,2025,aus,157,Swans Gmunden,Furstenfeld,98,64,35,17,25,21,19,17,19,9,52,46,36,28,-1
31.10.2025,2025,aus,162,Kapfenberg Bulls,BBC Nord,98,99,21,22,27,27,26,25,24,25,43,54,51,49,1
31.10.2025,2025,aus,151,Traiskirchen Lions,Oberwart Gunners,67,76,17,21,18,17,14,19,18,19,38,35,33,37,-1
31.10.2025,2025,aus,168,Vienna Basket,St. Polten,80,70,19,15,21,20,19,17,21,18,34,41,36,39,-1
31.10.2025,2025,aus,159,Graz UBSC,Wels,77,87,22,24,23,16,18,20,14,27,46,39,38,41,-1
03.11.2025,2025,aus,157,Klosterneuburg Dukes,x,81,85,18,20,23,19,15,27,25,19,38,42,42,44,1
03.11.2025,2025,aus,157,Kapfenberg Bulls,x,63,100,15,26,16,21,17,24,15,29,41,37,41,44,1
02.11.2025,2025,aus,155,Traiskirchen Lions,x,80,76,22,24,14,17,20,13,24,22,46,31,33,46,1
02.11.2025,2025,aus,162,Swans Gmunden,x,89,87,23,23,25,22,24,26,17,16,46,47,50,33,1
31.10.2025,2025,aus,157,Furstenfeld,x,98,64,35,17,25,21,19,17,19,9,52,46,36,28,-1
31.10.2025,2025,aus,162,BBC Nord,x,98,99,21,22,27,27,26,25,24,25,43,54,51,49,1
31.10.2025,2025,aus,151,Oberwart Gunners,x,67,76,17,21,18,17,14,19,18,19,38,35,33,37,-1
31.10.2025,2025,aus,168,St. Polten,x,80,70,19,15,21,20,19,17,21,18,34,41,36,39,-1
31.10.2025,2025,aus,159,Wels,x,77,87,22,24,23,16,18,20,14,27,46,39,38,41,-1
03.11.2025,2025,bnxt,156,Circus Brussels,LWD Basket,66,82,9,26,23,20,24,14,10,22,35,43,38,32,-1
03.11.2025,2025,bnxt,150,Spirou Charleroi,Okapi Aalst,72,81,22,28,21,19,12,17,17,17,50,40,29,34,-1
02.11.2025,2025,bnxt,168,Belfius Mons,Kortrijk,82,91,19,19,21,26,22,24,20,22,38,47,46,42,1
02.11.2025,2025,bnxt,158,Limburg,Den Bosch,92,61,24,9,26,18,25,13,17,21,33,44,38,38,-1
02.11.2025,2025,bnxt,155,Mechelen,Leuven Bears,72,67,15,19,21,13,24,20,12,15,34,34,44,27,-1
02.11.2025,2025,bnxt,165,Oostende,Zwolle,108,81,33,27,25,17,30,20,20,17,60,42,50,37,1
02.11.2025,2025,bnxt,163,BAL Weert,QSTA Utd,80,101,21,19,20,29,11,27,28,26,40,49,38,54,1
02.11.2025,2025,bnxt,155,Leiden,Feyenoord,92,86,30,20,20,21,14,25,28,20,50,41,39,48,1
02.11.2025,2025,bnxt,151,Den Helder,Antwerp Giants,68,99,18,22,15,28,17,25,18,24,40,43,42,42,1
03.11.2025,2025,bnxt,156,LWD Basket,x,66,82,9,26,23,20,24,14,10,22,35,43,38,32,-1
03.11.2025,2025,bnxt,150,Okapi Aalst,x,72,81,22,28,21,19,12,17,17,17,50,40,29,34,-1
02.11.2025,2025,bnxt,168,Kortrijk,x,82,91,19,19,21,26,22,24,20,22,38,47,46,42,1
02.11.2025,2025,bnxt,158,Den Bosch,x,92,61,24,9,26,18,25,13,17,21,33,44,38,38,-1
02.11.2025,2025,bnxt,155,Leuven Bears,x,72,67,15,19,21,13,24,20,12,15,34,34,44,27,-1
02.11.2025,2025,bnxt,165,Zwolle,x,108,81,33,27,25,17,30,20,20,17,60,42,50,37,1
02.11.2025,2025,bnxt,163,QSTA Utd,x,80,101,21,19,20,29,11,27,28,26,40,49,38,54,1
02.11.2025,2025,bnxt,155,Feyenoord,x,92,86,30,20,20,21,14,25,28,20,50,41,39,48,1
02.11.2025,2025,bnxt,151,Antwerp Giants,x,68,99,18,22,15,28,17,25,18,24,40,43,42,42,1
03.11.2025,2025,bos,168,Slavija,Orlovik,79,73,10,13,18,16,29,20,22,24,23,34,49,46,1
03.11.2025,2025,bos,155,Borac Banja Luka,Sloboda,80,68,22,15,23,20,19,17,16,16,37,43,36,32,-1
03.11.2025,2025,bos,162,Jahorina,Mrkonjic Grad,77,65,26,14,18,20,19,14,14,17,40,38,33,31,-1
02.11.2025,2025,bos,163,Leotar Trebinje,HKK Mostar,101,80,24,34,23,21,22,13,32,12,58,44,35,44,-1
02.11.2025,2025,bos,159,Spars Ilidza,Radnicki Gorazde,76,81,20,25,14,17,25,18,17,21,45,31,43,38,1
02.11.2025,2025,bos,153,Promo,Posusje,76,66,17,16,22,18,13,19,24,13,33,40,32,37,-1
02.11.2025,2025,bos,158,Siroki Brijeg,KK Bosna,85,86,22,21,20,21,22,26,21,18,43,41,48,39,1
03.11.2025,2025,bos,168,Orlovik,x,79,73,10,13,18,16,29,20,22,24,23,34,49,46,1
03.11.2025,2025,bos,155,Sloboda,x,80,68,22,15,23,20,19,17,16,16,37,43,36,32,-1
03.11.2025,2025,bos,162,Mrkonjic Grad,x,77,65,26,14,18,20,19,14,14,17,40,38,33,31,-1
02.11.2025,2025,bos,163,HKK Mostar,x,101,80,24,34,23,21,22,13,32,12,58,44,35,44,-1
02.11.2025,2025,bos,159,Radnicki Gorazde,x,76,81,20,25,14,17,25,18,17,21,45,31,43,38,1
02.11.2025,2025,bos,153,Posusje,x,76,66,17,16,22,18,13,19,24,13,33,40,32,37,-1
02.11.2025,2025,bos,158,KK Bosna,x,85,86,22,21,20,21,22,26,21,18,43,41,48,39,1
03.11.2025,2025,bul,163,Rilski Sportist,Cherno More,89,64,20,14,22,11,20,19,27,20,34,33,39,47,1
02.11.2025,2025,bul,170,Shumen,Balkan,67,68,16,18,13,23,19,15,19,12,34,36,34,31,-1
02.11.2025,2025,bul,171,Spartak Pleven,Beroe,83,88,29,27,15,18,15,22,24,21,56,33,37,45,-1
28.10.2025,2025,bul,162,Levski,Spartak Pleven,81,96,24,23,18,18,18,29,21,26,47,36,47,47,1
03.11.2025,2025,bul,163,Cherno More,x,89,64,20,14,22,11,20,19,27,20,34,33,39,47,1
02.11.2025,2025,bul,170,Balkan,x,67,68,16,18,13,23,19,15,19,12,34,36,34,31,-1
02.11.2025,2025,bul,171,Beroe,x,83,88,29,27,15,18,15,22,24,21,56,33,37,45,-1
28.10.2025,2025,bul,162,Spartak Pleven,x,81,96,24,23,18,18,18,29,21,26,47,36,47,47,1
03.11.2025,2025,cek,164,Usti n. Labem,Olomoucko,82,75,15,29,19,20,26,11,22,15,44,39,37,37,-1
02.11.2025,2025,cek,169,Opava,Jindrichuv Hradec,111,80,30,22,27,18,24,19,30,21,52,45,43,51,1
02.11.2025,2025,cek,166,NH Ostrava,USK Prague,86,71,19,22,23,14,30,15,14,20,41,37,45,34,-1
02.11.2025,2025,cek,157,Pardubice,Slavia Prague,87,104,21,25,28,21,16,27,22,31,46,49,43,53,1
02.11.2025,2025,cek,159,Brno,Decin,85,72,16,15,27,18,22,18,20,21,31,45,40,41,1
02.11.2025,2025,cek,175,Nymburk,Srsni Pisek,115,77,29,20,24,11,24,27,38,19,49,35,51,57,1
03.11.2025,2025,cek,164,Olomoucko,x,82,75,15,29,19,20,26,11,22,15,44,39,37,37,-1
02.11.2025,2025,cek,169,Jindrichuv Hradec,x,111,80,30,22,27,18,24,19,30,21,52,45,43,51,1
02.11.2025,2025,cek,166,USK Prague,x,86,71,19,22,23,14,30,15,14,20,41,37,45,34,-1
02.11.2025,2025,cek,157,Slavia Prague,x,87,104,21,25,28,21,16,27,22,31,46,49,43,53,1
02.11.2025,2025,cek,159,Decin,x,85,72,16,15,27,18,22,18,20,21,31,45,40,41,1
02.11.2025,2025,cek,175,Srsni Pisek,x,115,77,29,20,24,11,24,27,38,19,49,35,51,57,1
02.11.2025,2025,fin,165,Salon Vilpas,Karhu Basket,60,76,11,23,19,19,12,27,18,7,34,38,39,25,-1
01.11.2025,2025,fin,159,Bisons Loimaa,Helsinki Seagulls,100,102,16,17,19,20,20,23,18,13,33,39,43,31,-1
01.11.2025,2025,fin,165,Kobrat,BC Nokia,64,78,15,21,13,12,14,24,22,21,36,25,38,43,-1
01.11.2025,2025,fin,169,Kouvot Kouvola,Kataja,68,94,13,25,17,16,21,31,17,22,38,33,52,39,1
01.11.2025,2025,fin,168,KTP Kotka Basket,UU-Korihait Uusikaupunki,79,61,14,18,15,11,28,21,22,11,32,26,49,33,-1
01.11.2025,2025,fin,166,Honka,Pyrinto Tampere,65,78,14,21,24,16,20,21,7,20,35,40,41,27,-1
02.11.2025,2025,fin,165,Karhu Basket,x,60,76,11,23,19,19,12,27,18,7,34,38,39,25,-1
01.11.2025,2025,fin,159,Helsinki Seagulls,x,100,102,16,17,19,20,20,23,18,13,33,39,43,31,-1
01.11.2025,2025,fin,165,BC Nokia,x,64,78,15,21,13,12,14,24,22,21,36,25,38,43,-1
01.11.2025,2025,fin,169,Kataja,x,68,94,13,25,17,16,21,31,17,22,38,33,52,39,1
01.11.2025,2025,fin,168,UU-Korihait Uusikaupunki,x,79,61,14,18,15,11,28,21,22,11,32,26,49,33,-1
01.11.2025,2025,fin,166,Pyrinto Tampere,x,65,78,14,21,24,16,20,21,7,20,35,40,41,27,-1
03.11.2025,2025,fra,175,Paris,Nancy,115,97,30,22,34,25,25,19,26,31,52,59,44,57,1
03.11.2025,2025,fra,154,Gravelines-Dunkerque,Monaco,74,83,21,23,28,24,8,15,17,21,44,52,23,38,-1
03.11.2025,2025,fra,162,Lyon-Villeurbanne,Cholet,87,101,19,21,22,29,23,28,23,23,40,51,51,46,1
02.11.2025,2025,fra,163,Le Mans,Dijon,98,71,22,17,29,16,27,19,20,19,39,45,46,39,1
02.11.2025,2025,fra,156,Nanterre,Saint Quentin,95,102,24,15,25,25,21,20,16,26,39,50,41,42,1
02.11.2025,2025,fra,163,JL Bourg,Strasbourg,89,96,16,17,29,27,20,24,24,28,33,56,44,52,1
01.11.2025,2025,fra,149,Le Portel,La Rochelle,83,62,23,16,21,17,17,16,22,13,39,38,33,35,-1
01.11.2025,2025,fra,162,Limoges,Chalon/Saone,74,68,19,17,16,14,20,20,19,17,36,30,40,36,-1
02.11.2025,2025,fra b,150,Orleans,Fos-sur-Mer,90,78,29,22,23,14,18,21,20,21,51,37,39,41,1
01.11.2025,2025,fra b,159,ASA,Hyeres-Toulon,69,74,27,15,14,21,9,15,19,23,42,35,24,42,-1
01.11.2025,2025,fra b,166,St. Chamond,Ada Blois,76,99,19,29,21,25,21,22,15,23,48,46,43,38,-1
01.11.2025,2025,fra b,174,Aix Maurienne,Chartres,85,79,25,14,17,23,18,16,25,26,39,40,34,51,-1
01.11.2025,2025,fra b,150,Caen,Boulazac,87,83,16,16,19,25,21,21,17,11,32,44,42,28,-1
01.11.2025,2025,fra b,159,Denain-Voltaire,Vichy,80,62,25,15,23,21,17,13,15,13,40,44,30,28,-1
01.11.2025,2025,fra b,160,Evreux,Chalons-Reims,96,74,23,28,28,16,25,17,20,13,51,44,42,33,-1
01.11.2025,2025,fra b,159,Nantes,Antibes,79,82,16,23,23,16,19,21,21,22,39,39,40,43,1
01.11.2025,2025,fra b,163,Pau-Orthez,Roanne,81,77,17,16,21,18,22,17,21,26,33,39,39,47,1
01.11.2025,2025,fra b,162,Poitiers,Rouen,89,76,23,18,19,16,26,17,21,25,41,35,43,46,1
29.10.2025,2025,fra b,159,Ada Blois,Orleans,75,82,24,15,23,18,12,26,16,23,39,41,38,39,-1
29.10.2025,2025,fra b,157,Hyeres-Toulon,Chalons-Reims,81,79,16,24,18,14,26,15,21,26,40,32,41,47,1
29.10.2025,2025,fra b,154,Vichy,Fos-sur-Mer,82,71,21,21,25,25,16,9,20,16,42,50,25,36,-1
29.10.2025,2025,fra b,169,Aix Maurienne,Poitiers,107,99,21,20,24,27,23,14,18,25,41,51,37,43,-1
29.10.2025,2025,fra b,165,Antibes,St. Chamond,103,66,27,11,29,19,15,13,32,23,38,48,28,55,1
29.10.2025,2025,fra b,159,Boulazac,ASA,68,65,15,13,19,27,19,14,15,11,28,46,33,26,-1
29.10.2025,2025,fra b,157,Caen,Nantes,89,77,23,23,23,15,16,15,27,24,46,38,31,51,1
29.10.2025,2025,fra b,165,Chartres,Pau-Orthez,90,82,17,26,27,24,15,17,31,15,43,51,32,46,-1
29.10.2025,2025,fra b,161,Evreux,Denain-Voltaire,76,83,17,33,27,8,20,21,12,21,50,35,41,33,-1
29.10.2025,2025,fra b,168,Rouen,Roanne,75,90,20,16,16,35,20,20,19,19,36,51,40,38,-1
03.11.2025,2025,fra,175,Nancy,x,115,97,30,22,34,25,25,19,26,31,52,59,44,57,1
03.11.2025,2025,fra,154,Monaco,x,74,83,21,23,28,24,8,15,17,21,44,52,23,38,-1
03.11.2025,2025,fra,162,Cholet,x,87,101,19,21,22,29,23,28,23,23,40,51,51,46,1
02.11.2025,2025,fra,163,Dijon,x,98,71,22,17,29,16,27,19,20,19,39,45,46,39,1
02.11.2025,2025,fra,156,Saint Quentin,x,95,102,24,15,25,25,21,20,16,26,39,50,41,42,1
02.11.2025,2025,fra,163,Strasbourg,x,89,96,16,17,29,27,20,24,24,28,33,56,44,52,1
01.11.2025,2025,fra,149,La Rochelle,x,83,62,23,16,21,17,17,16,22,13,39,38,33,35,-1
01.11.2025,2025,fra,162,Chalon/Saone,x,74,68,19,17,16,14,20,20,19,17,36,30,40,36,-1
02.11.2025,2025,fra b,150,Fos-sur-Mer,x,90,78,29,22,23,14,18,21,20,21,51,37,39,41,1
01.11.2025,2025,fra b,159,Hyeres-Toulon,x,69,74,27,15,14,21,9,15,19,23,42,35,24,42,-1
01.11.2025,2025,fra b,166,Ada Blois,x,76,99,19,29,21,25,21,22,15,23,48,46,43,38,-1
01.11.2025,2025,fra b,174,Chartres,x,85,79,25,14,17,23,18,16,25,26,39,40,34,51,-1
01.11.2025,2025,fra b,150,Boulazac,x,87,83,16,16,19,25,21,21,17,11,32,44,42,28,-1
01.11.2025,2025,fra b,159,Vichy,x,80,62,25,15,23,21,17,13,15,13,40,44,30,28,-1
01.11.2025,2025,fra b,160,Chalons-Reims,x,96,74,23,28,28,16,25,17,20,13,51,44,42,33,-1
01.11.2025,2025,fra b,159,Antibes,x,79,82,16,23,23,16,19,21,21,22,39,39,40,43,1
01.11.2025,2025,fra b,163,Roanne,x,81,77,17,16,21,18,22,17,21,26,33,39,39,47,1
01.11.2025,2025,fra b,162,Rouen,x,89,76,23,18,19,16,26,17,21,25,41,35,43,46,1
29.10.2025,2025,fra b,159,Orleans,x,75,82,24,15,23,18,12,26,16,23,39,41,38,39,-1
29.10.2025,2025,fra b,157,Chalons-Reims,x,81,79,16,24,18,14,26,15,21,26,40,32,41,47,1
29.10.2025,2025,fra b,154,Fos-sur-Mer,x,82,71,21,21,25,25,16,9,20,16,42,50,25,36,-1
29.10.2025,2025,fra b,169,Poitiers,x,107,99,21,20,24,27,23,14,18,25,41,51,37,43,-1
29.10.2025,2025,fra b,165,St. Chamond,x,103,66,27,11,29,19,15,13,32,23,38,48,28,55,1
29.10.2025,2025,fra b,159,ASA,x,68,65,15,13,19,27,19,14,15,11,28,46,33,26,-1
29.10.2025,2025,fra b,157,Nantes,x,89,77,23,23,23,15,16,15,27,24,46,38,31,51,1
29.10.2025,2025,fra b,165,Pau-Orthez,x,90,82,17,26,27,24,15,17,31,15,43,51,32,46,-1
29.10.2025,2025,fra b,161,Denain-Voltaire,x,76,83,17,33,27,8,20,21,12,21,50,35,41,33,-1
29.10.2025,2025,fra b,168,Roanne,x,75,90,20,16,16,35,20,20,19,19,36,51,40,38,-1
03.11.2025,2025,ger b,163,Artland,Kirchheim,75,94,21,24,20,25,21,20,13,25,45,45,41,38,-1
03.11.2025,2025,ger b,159,Bremerhaven,Koblenz,83,73,23,10,21,17,16,25,23,21,33,38,41,44,1
02.11.2025,2025,ger b,167,Crailsheim Merlins,Giessen,78,80,21,23,24,16,14,21,19,20,44,40,35,39,-1
02.11.2025,2025,ger b,160,Munster,Nurnberger,94,85,29,14,21,21,24,21,20,29,43,42,45,49,1
02.11.2025,2025,ger b,160,PS Karlsruhe,Dusseldorf,78,64,15,12,15,17,25,16,23,19,27,32,41,42,1
02.11.2025,2025,ger b,165,Trier,Phoenix Hagen,75,78,21,14,21,21,16,20,17,23,35,42,36,40,-1
02.11.2025,2025,ger b,159,Jena,Tubingen,79,65,11,17,19,21,33,16,16,11,28,40,49,27,-1
02.11.2025,2025,ger b,160,Dresden,Bochum,83,96,23,27,19,22,24,19,17,28,50,41,43,45,1
02.11.2025,2025,ger b,174,Vechta 2,Bayreuth,79,86,15,21,23,31,17,21,24,13,36,54,38,37,-1
03.11.2025,2025,ger,157,Basketball Braunschweig,Bayern,72,90,20,17,15,24,19,29,18,20,37,39,48,38,1
03.11.2025,2025,ger,166,Syntainics MBC,Oldenburg,92,77,21,16,24,18,27,25,20,18,37,42,52,38,1
03.11.2025,2025,ger,161,Bamberg,Alba Berlin,87,82,18,18,21,16,22,24,26,24,36,37,46,50,1
03.11.2025,2025,ger,165,Chemnitz,Gottingen,96,88,23,25,26,16,27,22,20,25,48,42,49,45,1
02.11.2025,2025,ger,159,Ludwigsburg,Vechta,77,79,24,13,14,20,19,29,20,17,37,34,48,37,1
02.11.2025,2025,ger,169,Ulm,Hamburg,82,72,25,12,14,27,21,17,22,16,37,41,38,38,-1
02.11.2025,2025,ger,166,Heidelberg,Wurzburg,67,72,19,11,8,20,23,26,17,15,30,28,49,32,-1
01.11.2025,2025,ger,152,Rostock,Frankfurt,83,66,23,16,22,25,18,16,20,9,39,47,34,29,-1
28.10.2025,2025,ger,163,Bonn,Ludwigsburg,79,89,21,22,13,24,17,24,28,19,43,37,41,47,1
03.11.2025,2025,ger b,163,Kirchheim,x,75,94,21,24,20,25,21,20,13,25,45,45,41,38,-1
03.11.2025,2025,ger b,159,Koblenz,x,83,73,23,10,21,17,16,25,23,21,33,38,41,44,1
02.11.2025,2025,ger b,167,Giessen,x,78,80,21,23,24,16,14,21,19,20,44,40,35,39,-1
02.11.2025,2025,ger b,160,Nurnberger,x,94,85,29,14,21,21,24,21,20,29,43,42,45,49,1
02.11.2025,2025,ger b,160,Dusseldorf,x,78,64,15,12,15,17,25,16,23,19,27,32,41,42,1
02.11.2025,2025,ger b,165,Phoenix Hagen,x,75,78,21,14,21,21,16,20,17,23,35,42,36,40,-1
02.11.2025,2025,ger b,159,Tubingen,x,79,65,11,17,19,21,33,16,16,11,28,40,49,27,-1
02.11.2025,2025,ger b,160,Bochum,x,83,96,23,27,19,22,24,19,17,28,50,41,43,45,1
02.11.2025,2025,ger b,174,Bayreuth,x,79,86,15,21,23,31,17,21,24,13,36,54,38,37,-1
03.11.2025,2025,ger,157,Bayern,x,72,90,20,17,15,24,19,29,18,20,37,39,48,38,1
03.11.2025,2025,ger,166,Oldenburg,x,92,77,21,16,24,18,27,25,20,18,37,42,52,38,1
03.11.2025,2025,ger,161,Alba Berlin,x,87,82,18,18,21,16,22,24,26,24,36,37,46,50,1
03.11.2025,2025,ger,165,Gottingen,x,96,88,23,25,26,16,27,22,20,25,48,42,49,45,1
02.11.2025,2025,ger,159,Vechta,x,77,79,24,13,14,20,19,29,20,17,37,34,48,37,1
02.11.2025,2025,ger,169,Hamburg,x,82,72,25,12,14,27,21,17,22,16,37,41,38,38,-1
02.11.2025,2025,ger,166,Wurzburg,x,67,72,19,11,8,20,23,26,17,15,30,28,49,32,-1
01.11.2025,2025,ger,152,Frankfurt,x,83,66,23,16,22,25,18,16,20,9,39,47,34,29,-1
28.10.2025,2025,ger,163,Ludwigsburg,x,79,89,21,22,13,24,17,24,28,19,43,37,41,47,1
03.11.2025,2025,greek,162,Panathinaikos,Promitheas,92,67,24,13,14,20,32,15,22,19,37,34,47,41,1
03.11.2025,2025,greek,160,AEK Athens,Olympiacos,77,96,16,26,25,19,15,19,21,32,42,44,34,53,1
02.11.2025,2025,greek,160,Maroussi,PAOK,80,81,17,23,14,12,17,24,32,22,40,26,41,54,1
02.11.2025,2025,greek,153,AS Karditsas,Kolossos Rhodes,98,73,25,23,25,15,17,14,31,21,48,40,31,52,1
02.11.2025,2025,greek,152,Aris,Peristeri,77,71,10,16,28,19,10,18,29,18,26,47,28,47,-1
28.10.2025,2025,greek,160,Peristeri,Lavrio,84,82,18,26,22,16,13,23,31,17,44,38,36,48,1
03.11.2025,2025,greek,162,Promitheas,x,92,67,24,13,14,20,32,15,22,19,37,34,47,41,1
03.11.2025,2025,greek,160,Olympiacos,x,77,96,16,26,25,19,15,19,21,32,42,44,34,53,1
02.11.2025,2025,greek,160,PAOK,x,80,81,17,23,14,12,17,24,32,22,40,26,41,54,1
02.11.2025,2025,greek,153,Kolossos Rhodes,x,98,73,25,23,25,15,17,14,31,21,48,40,31,52,1
02.11.2025,2025,greek,152,Peristeri,x,77,71,10,16,28,19,10,18,29,18,26,47,28,47,-1
28.10.2025,2025,greek,160,Lavrio,x,84,82,18,26,22,16,13,23,31,17,44,38,36,48,1
03.11.2025,2025,kıbrıs,164,AEK Larnaca,Apoel BC,80,61,18,20,12,11,23,11,27,19,38,23,34,46,-1
02.11.2025,2025,kıbrıs,168,Achilleas K.,Keravnos,53,97,17,20,17,22,9,24,10,31,37,39,33,41,-1
01.11.2025,2025,kıbrıs,163,Paralimni,Apollon,84,81,25,18,22,19,21,19,16,25,43,41,40,41,-1
03.11.2025,2025,kıbrıs,164,Apoel BC,x,80,61,18,20,12,11,23,11,27,19,38,23,34,46,-1
02.11.2025,2025,kıbrıs,168,Keravnos,x,53,97,17,20,17,22,9,24,10,31,37,39,33,41,-1
01.11.2025,2025,kıbrıs,163,Apollon,x,84,81,25,18,22,19,21,19,16,25,43,41,40,41,-1
03.11.2025,2025,ita,155,Pistoia,Reggiana,73,70,16,24,15,16,23,14,19,16,40,31,37,35,-1
03.11.2025,2025,ita,165,Virtus Bologna,Treviso,104,97,27,27,21,27,36,21,20,22,54,48,57,42,1
03.11.2025,2025,ita,162,Basket Napoli,Venezia,80,81,26,21,20,15,19,15,15,30,47,35,34,45,-1
03.11.2025,2025,ita,163,Trento,Olimpia Milano,91,57,21,18,27,11,18,13,25,15,39,38,31,40,-1
03.11.2025,2025,ita,163,Tortona,Sassari,71,68,18,23,17,11,11,10,25,24,41,28,21,49,-1
03.11.2025,2025,ita,188,Trieste,Varese,107,81,27,15,23,17,24,21,33,28,42,40,45,61,1
03.11.2025,2025,ita,161,Scafati,Cremona,85,77,22,20,24,22,21,19,18,16,42,46,40,34,-1
02.11.2025,2025,ita,175,Brescia,Trapani,74,95,17,32,19,22,22,23,16,18,49,41,45,34,-1
03.11.2025,2025,ita b,152,Avellino Basket,Udine,63,76,17,22,16,14,15,22,15,18,39,30,37,33,-1
03.11.2025,2025,ita b,148,Cento,Brindisi,70,66,15,19,23,14,12,22,20,11,34,37,34,31,-1
03.11.2025,2025,ita b,152,Fortitudo Bologna,Verona,70,67,22,13,13,22,17,16,18,16,35,35,33,34,-1
03.11.2025,2025,ita b,151,Nardo,Sebastiani Rieti,81,71,18,13,24,17,22,15,17,26,31,41,37,43,1
03.11.2025,2025,ita b,158,Pesaro,Orzinuovi,67,65,18,21,19,17,15,10,15,17,39,36,25,32,-1
03.11.2025,2025,ita b,154,Vigevano,Urania Milano,66,80,26,20,21,21,13,26,6,13,46,42,39,19,-1
02.11.2025,2025,ita b,147,Forli,Libertas Livorno,67,69,13,18,21,14,20,20,13,17,31,35,40,30,-1
02.11.2025,2025,ita b,161,JuVi Cremona,Assigeco Piacenza,68,72,22,17,12,13,13,16,21,26,39,25,29,47,-1
01.11.2025,2025,ita b,156,Basket Torino,Rimini,68,80,11,19,20,19,15,21,22,21,30,39,36,43,1
01.11.2025,2025,ita b,151,Cividale,Cantu,80,72,20,16,15,16,26,23,19,17,36,31,49,36,1
03.11.2025,2025,ita,155,Reggiana,x,73,70,16,24,15,16,23,14,19,16,40,31,37,35,-1
03.11.2025,2025,ita,165,Treviso,x,104,97,27,27,21,27,36,21,20,22,54,48,57,42,1
03.11.2025,2025,ita,162,Venezia,x,80,81,26,21,20,15,19,15,15,30,47,35,34,45,-1
03.11.2025,2025,ita,163,Olimpia Milano,x,91,57,21,18,27,11,18,13,25,15,39,38,31,40,-1
03.11.2025,2025,ita,163,Sassari,x,71,68,18,23,17,11,11,10,25,24,41,28,21,49,-1
03.11.2025,2025,ita,188,Varese,x,107,81,27,15,23,17,24,21,33,28,42,40,45,61,1
03.11.2025,2025,ita,161,Cremona,x,85,77,22,20,24,22,21,19,18,16,42,46,40,34,-1
02.11.2025,2025,ita,175,Trapani,x,74,95,17,32,19,22,22,23,16,18,49,41,45,34,-1
03.11.2025,2025,ita b,152,Udine,x,63,76,17,22,16,14,15,22,15,18,39,30,37,33,-1
03.11.2025,2025,ita b,148,Brindisi,x,70,66,15,19,23,14,12,22,20,11,34,37,34,31,-1
03.11.2025,2025,ita b,152,Verona,x,70,67,22,13,13,22,17,16,18,16,35,35,33,34,-1
03.11.2025,2025,ita b,151,Sebastiani Rieti,x,81,71,18,13,24,17,22,15,17,26,31,41,37,43,1
03.11.2025,2025,ita b,158,Orzinuovi,x,67,65,18,21,19,17,15,10,15,17,39,36,25,32,-1
03.11.2025,2025,ita b,154,Urania Milano,x,66,80,26,20,21,21,13,26,6,13,46,42,39,19,-1
02.11.2025,2025,ita b,147,Libertas Livorno,x,67,69,13,18,21,14,20,20,13,17,31,35,40,30,-1
02.11.2025,2025,ita b,161,Assigeco Piacenza,x,68,72,22,17,12,13,13,16,21,26,39,25,29,47,-1
01.11.2025,2025,ita b,156,Rimini,x,68,80,11,19,20,19,15,21,22,21,30,39,36,43,1
01.11.2025,2025,ita b,151,Cantu,x,80,72,20,16,15,16,26,23,19,17,36,31,49,36,1
03.11.2025,2025,lat-st,161,Keila Coolbet,BK Ogre,80,75,24,23,24,16,11,15,21,21,47,40,26,42,-1
02.11.2025,2025,lat-st,151,BC Kalev/Cramo,Viimsi,99,61,26,16,26,15,26,17,21,13,42,41,43,34,1
02.11.2025,2025,lat-st,166,Keila KK,Valmiera Glass Via,71,94,26,27,13,13,12,27,20,27,53,26,39,47,1
02.11.2025,2025,lat-st,152,VEF Riga,Parnu,75,70,23,20,25,8,12,27,15,15,43,33,39,30,-1
02.11.2025,2025,lat-st,158,Latvijas Universitate,Tal Tech,66,75,9,22,18,19,23,15,16,19,31,37,38,35,-1
01.11.2025,2025,lat-st,160,Rapla,Rigas Zelli,66,96,25,14,18,28,13,28,10,26,39,46,41,36,-1
01.11.2025,2025,lat-st,166,Ventspils,Tartu Ulikool,92,93,16,22,24,26,27,24,25,21,38,50,51,46,1
30.10.2025,2025,lat-st,158,BK Liepaja,Tartu Ulikool,63,66,19,20,12,20,20,9,12,17,39,32,29,29,-1
30.10.2025,2025,lat-st,165,Tal Tech,Rigas Zelli,76,113,13,35,22,25,17,24,24,29,48,47,41,53,1
29.10.2025,2025,lat-st,152,Valmiera Glass Via,Viimsi,79,49,15,19,19,10,17,10,28,10,34,29,27,38,-1
03.11.2025,2025,lat lkl,172,Mazeikiai,Nevezis,77,98,13,29,22,20,23,30,19,19,42,42,53,38,1
03.11.2025,2025,lat lkl,160,Zalgiris Kaunas,Juventus,84,67,20,9,20,22,21,10,23,26,29,42,31,49,-1
03.11.2025,2025,lat lkl,182,Jonava,Rytas,74,94,21,16,25,36,12,23,16,19,37,61,35,35,-1
02.11.2025,2025,lat lkl,162,Lietkabelis,Neptunas,81,89,18,23,14,20,21,21,28,25,41,34,42,53,1
02.11.2025,2025,lat lkl,175,BC Wolves,Siauliai,103,93,23,19,26,24,25,26,29,24,42,50,51,53,1
02.11.2025,2025,lat nkl,164,Jurbarkas,Ukmerges Stekas,77,65,20,14,16,9,21,18,20,24,34,25,39,44,1
02.11.2025,2025,lat nkl,160,Omega-Tauras,Alytaus Alytus,92,64,17,18,25,16,22,9,28,21,35,41,31,49,-1
02.11.2025,2025,lat nkl,160,Neptunas 2,Delikatesas Joniskis,102,79,25,14,28,17,24,26,25,22,39,45,50,47,1
02.11.2025,2025,lat nkl,165,Plunges Olimpas,Suduva-Mantinga,61,80,23,21,11,22,14,22,13,15,44,33,36,28,-1
02.11.2025,2025,lat nkl,165,Silute,Kretinga,77,76,17,21,21,22,17,10,22,23,38,43,27,45,-1
02.11.2025,2025,lat nkl,179,Vytis VDU,Rytas 2,86,69,26,19,13,25,25,10,22,15,45,38,35,37,-1
02.11.2025,2025,lat nkl,153,Zalgiris Kaunas 2,BC Olimpas Palanga,74,89,15,29,20,22,14,17,25,21,44,42,31,46,1
02.11.2025,2025,lat nkl,161,Vilkaviskis,Telsiai,104,73,24,11,18,29,25,14,37,19,35,47,39,56,1
03.11.2025,2025,lat-st,161,BK Ogre,x,80,75,24,23,24,16,11,15,21,21,47,40,26,42,-1
02.11.2025,2025,lat-st,151,Viimsi,x,99,61,26,16,26,15,26,17,21,13,42,41,43,34,1
02.11.2025,2025,lat-st,166,Valmiera Glass Via,x,71,94,26,27,13,13,12,27,20,27,53,26,39,47,1
02.11.2025,2025,lat-st,152,Parnu,x,75,70,23,20,25,8,12,27,15,15,43,33,39,30,-1
02.11.2025,2025,lat-st,158,Tal Tech,x,66,75,9,22,18,19,23,15,16,19,31,37,38,35,-1
01.11.2025,2025,lat-st,160,Rigas Zelli,x,66,96,25,14,18,28,13,28,10,26,39,46,41,36,-1
01.11.2025,2025,lat-st,166,Tartu Ulikool,x,92,93,16,22,24,26,27,24,25,21,38,50,51,46,1
30.10.2025,2025,lat-st,158,Tartu Ulikool,x,63,66,19,20,12,20,20,9,12,17,39,32,29,29,-1
30.10.2025,2025,lat-st,165,Rigas Zelli,x,76,113,13,35,22,25,17,24,24,29,48,47,41,53,1
29.10.2025,2025,lat-st,152,Viimsi,x,79,49,15,19,19,10,17,10,28,10,34,29,27,38,-1
03.11.2025,2025,lat lkl,172,Nevezis,x,77,98,13,29,22,20,23,30,19,19,42,42,53,38,1
03.11.2025,2025,lat lkl,160,Juventus,x,84,67,20,9,20,22,21,10,23,26,29,42,31,49,-1
03.11.2025,2025,lat lkl,182,Rytas,x,74,94,21,16,25,36,12,23,16,19,37,61,35,35,-1
02.11.2025,2025,lat lkl,162,Neptunas,x,81,89,18,23,14,20,21,21,28,25,41,34,42,53,1
02.11.2025,2025,lat lkl,175,Siauliai,x,103,93,23,19,26,24,25,26,29,24,42,50,51,53,1
02.11.2025,2025,lat nkl,164,Ukmerges Stekas,x,77,65,20,14,16,9,21,18,20,24,34,25,39,44,1
02.11.2025,2025,lat nkl,160,Alytaus Alytus,x,92,64,17,18,25,16,22,9,28,21,35,41,31,49,-1
02.11.2025,2025,lat nkl,160,Delikatesas Joniskis,x,102,79,25,14,28,17,24,26,25,22,39,45,50,47,1
02.11.2025,2025,lat nkl,165,Suduva-Mantinga,x,61,80,23,21,11,22,14,22,13,15,44,33,36,28,-1
02.11.2025,2025,lat nkl,165,Kretinga,x,77,76,17,21,21,22,17,10,22,23,38,43,27,45,-1
02.11.2025,2025,lat nkl,179,Rytas 2,x,86,69,26,19,13,25,25,10,22,15,45,38,35,37,-1
02.11.2025,2025,lat nkl,153,BC Olimpas Palanga,x,74,89,15,29,20,22,14,17,25,21,44,42,31,46,1
02.11.2025,2025,lat nkl,161,Telsiai,x,104,73,24,11,18,29,25,14,37,19,35,47,39,56,1
02.11.2025,2025,mac,174,Alba Fehervar,Szedeak,110,85,28,31,24,26,29,18,29,10,59,50,47,39,-1
02.11.2025,2025,mac,159,Soproni KC,Szombathely,76,89,11,20,23,26,21,26,21,17,31,49,47,38,1
02.11.2025,2025,mac,169,Szolnoki Olaj,Kormend,101,95,35,22,29,21,19,25,18,27,57,50,44,45,1
02.11.2025,2025,mac,169,Zalakeramia,Atomeromu Paks,86,90,20,19,25,17,21,22,20,32,39,42,43,52,1
02.11.2025,2025,mac,148,Budapesti Honved Se,OSE Lions,81,77,21,18,19,11,18,18,23,30,39,30,36,53,1
01.11.2025,2025,mac,163,Pecsi VSK,KTE-Duna,88,76,20,24,24,19,29,15,15,18,44,43,44,33,-1
30.10.2025,2025,mac,159,Szedeak,Budapesti Honved Se,57,75,14,24,13,23,17,15,13,13,38,36,32,26,-1
30.10.2025,2025,mac,164,Atomeromu Paks,NKA Pecs,102,81,27,19,20,19,21,13,34,30,46,39,34,64,1
30.10.2025,2025,mac,176,Kormend,Zalakeramia,91,78,22,27,26,15,22,17,21,19,49,41,39,40,-1
30.10.2025,2025,mac,159,OSE Lions,Soproni KC,68,80,15,20,16,23,26,14,11,23,35,39,40,34,-1
02.11.2025,2025,mac,174,Szedeak,x,110,85,28,31,24,26,29,18,29,10,59,50,47,39,-1
02.11.2025,2025,mac,159,Szombathely,x,76,89,11,20,23,26,21,26,21,17,31,49,47,38,1
02.11.2025,2025,mac,169,Kormend,x,101,95,35,22,29,21,19,25,18,27,57,50,44,45,1
02.11.2025,2025,mac,169,Atomeromu Paks,x,86,90,20,19,25,17,21,22,20,32,39,42,43,52,1
02.11.2025,2025,mac,148,OSE Lions,x,81,77,21,18,19,11,18,18,23,30,39,30,36,53,1
01.11.2025,2025,mac,163,KTE-Duna,x,88,76,20,24,24,19,29,15,15,18,44,43,44,33,-1
30.10.2025,2025,mac,159,Budapesti Honved Se,x,57,75,14,24,13,23,17,15,13,13,38,36,32,26,-1
30.10.2025,2025,mac,164,NKA Pecs,x,102,81,27,19,20,19,21,13,34,30,46,39,34,64,1
30.10.2025,2025,mac,176,Zalakeramia,x,91,78,22,27,26,15,22,17,21,19,49,41,39,40,-1
30.10.2025,2025,mac,159,Soproni KC,x,68,80,15,20,16,23,26,14,11,23,35,39,40,34,-1
03.11.2025,2025,mak,159,Tikvesh,Feniks 2010,97,84,20,21,24,22,26,22,27,19,41,46,48,46,1
02.11.2025,2025,mak,160,Pelister,Kozuv,92,87,20,17,23,20,27,22,22,28,37,43,49,50,1
02.11.2025,2025,mak,150,MKK Kumanovo,Gostivar,71,62,18,22,18,10,16,12,19,18,40,28,28,37,-1
02.11.2025,2025,mak,151,Vardar,Rabotnicki,71,79,20,17,19,25,18,18,14,19,37,44,36,33,-1
02.11.2025,2025,mak,152,TFT Skopje,Shkupi Skopje,82,73,14,16,26,18,30,15,12,24,30,44,45,36,1
02.11.2025,2025,mak,158,Cair 2030,MZT Skopje,95,94,23,24,21,16,17,18,21,24,47,37,35,45,1
03.11.2025,2025,mak,159,Feniks 2010,x,97,84,20,21,24,22,26,22,27,19,41,46,48,46,1
02.11.2025,2025,mak,160,Kozuv,x,92,87,20,17,23,20,27,22,22,28,37,43,49,50,1
02.11.2025,2025,mak,150,Gostivar,x,71,62,18,22,18,10,16,12,19,18,40,28,28,37,-1
02.11.2025,2025,mak,151,Rabotnicki,x,71,79,20,17,19,25,18,18,14,19,37,44,36,33,-1
02.11.2025,2025,mak,152,Shkupi Skopje,x,82,73,14,16,26,18,30,15,12,24,30,44,45,36,1
02.11.2025,2025,mak,158,MZT Skopje,x,95,94,23,24,21,16,17,18,21,24,47,37,35,45,1
03.11.2025,2025,pol,162,Czarni Slupsk,Legia,83,60,26,21,18,10,23,23,16,6,47,28,46,22,-1
02.11.2025,2025,pol,162,Szczecin,Trefl Sopot,96,99,34,22,18,18,24,30,20,29,56,36,54,49,1
02.11.2025,2025,pol,163,Slask Wroclaw,Dabrowa Gornicza,78,93,16,25,21,24,24,24,17,20,41,45,48,37,1
02.11.2025,2025,pol,165,Ostrow Wielkopolski,Anwil Wloclawek,85,87,28,19,20,21,20,19,17,28,47,41,39,45,1
02.11.2025,2025,pol,153,Dziki Warszawa,Gornik Walbrzych,68,92,13,28,19,22,20,13,16,29,41,41,33,45,1
02.11.2025,2025,pol,164,Spojnia Stargard,Torun,67,79,19,19,21,20,14,24,13,16,38,41,38,29,-1
31.10.2025,2025,pol,170,Zielona Gora,GTK Gliwice,98,83,25,24,19,24,31,15,23,20,49,43,46,43,1
31.10.2025,2025,pol,180,Lublin,Gdynia,96,72,27,13,12,18,33,13,24,28,40,30,46,52,1
03.11.2025,2025,pol,162,Legia,x,83,60,26,21,18,10,23,23,16,6,47,28,46,22,-1
02.11.2025,2025,pol,162,Trefl Sopot,x,96,99,34,22,18,18,24,30,20,29,56,36,54,49,1
02.11.2025,2025,pol,163,Dabrowa Gornicza,x,78,93,16,25,21,24,24,24,17,20,41,45,48,37,1
02.11.2025,2025,pol,165,Anwil Wloclawek,x,85,87,28,19,20,21,20,19,17,28,47,41,39,45,1
02.11.2025,2025,pol,153,Gornik Walbrzych,x,68,92,13,28,19,22,20,13,16,29,41,41,33,45,1
02.11.2025,2025,pol,164,Torun,x,67,79,19,19,21,20,14,24,13,16,38,41,38,29,-1
31.10.2025,2025,pol,170,GTK Gliwice,x,98,83,25,24,19,24,31,15,23,20,49,43,46,43,1
31.10.2025,2025,pol,180,Gdynia,x,96,72,27,13,12,18,33,13,24,28,40,30,46,52,1
03.11.2025,2025,por,156,Sporting CP,CA Queluz,104,81,20,19,27,24,26,17,31,21,39,51,43,52,1
02.11.2025,2025,por,155,CD Povoa,Ovarense,69,75,23,24,16,18,22,23,8,10,47,34,45,18,-1
02.11.2025,2025,por,158,Benfica,FC Porto,82,77,15,19,18,17,22,19,27,22,34,35,41,49,1
02.11.2025,2025,por,153,Galitos Barreiro,Galomar,85,82,27,27,17,23,28,14,13,18,54,40,42,31,-1
02.11.2025,2025,por,155,Oliveirense,Imortal,90,60,23,14,20,15,21,17,26,14,37,35,38,40,1
02.11.2025,2025,por,159,Vitoria,Esgueira,79,82,12,18,23,20,21,24,23,20,30,43,45,43,1
03.11.2025,2025,por b,142,Imortal B,Benfica Lisboa B,81,63,17,17,23,18,18,12,23,16,34,41,30,39,-1
02.11.2025,2025,por b,148,Sampaense,Galitos Aveiro,75,69,28,18,14,19,13,15,20,17,46,33,28,37,-1
01.11.2025,2025,por b,140,Barreirense,Portimonense,72,60,24,14,11,14,20,17,17,15,38,25,37,32,-1
01.11.2025,2025,por b,157,Braga,Vasco Da Gama,82,76,25,22,24,14,16,16,17,24,47,38,32,41,-1
01.11.2025,2025,por b,146,Maia,Sangalhos,86,83,19,21,23,23,21,17,23,22,40,46,38,45,1
01.11.2025,2025,por b,146,CAB Madeira,Santo Andre,89,71,19,20,24,26,19,13,27,12,39,50,32,39,-1
01.11.2025,2025,por b,146,Illiabum,Ginasio,77,78,24,23,20,12,10,21,23,22,47,32,31,45,1
01.11.2025,2025,por b,140,CB Queluz,Lusitania,79,57,24,13,20,16,20,11,15,17,37,36,31,32,-1
03.11.2025,2025,por,156,CA Queluz,x,104,81,20,19,27,24,26,17,31,21,39,51,43,52,1
02.11.2025,2025,por,155,Ovarense,x,69,75,23,24,16,18,22,23,8,10,47,34,45,18,-1
02.11.2025,2025,por,158,FC Porto,x,82,77,15,19,18,17,22,19,27,22,34,35,41,49,1
02.11.2025,2025,por,153,Galomar,x,85,82,27,27,17,23,28,14,13,18,54,40,42,31,-1
02.11.2025,2025,por,155,Imortal,x,90,60,23,14,20,15,21,17,26,14,37,35,38,40,1
02.11.2025,2025,por,159,Esgueira,x,79,82,12,18,23,20,21,24,23,20,30,43,45,43,1
03.11.2025,2025,por b,142,Benfica Lisboa B,x,81,63,17,17,23,18,18,12,23,16,34,41,30,39,-1
02.11.2025,2025,por b,148,Galitos Aveiro,x,75,69,28,18,14,19,13,15,20,17,46,33,28,37,-1
01.11.2025,2025,por b,140,Portimonense,x,72,60,24,14,11,14,20,17,17,15,38,25,37,32,-1
01.11.2025,2025,por b,157,Vasco Da Gama,x,82,76,25,22,24,14,16,16,17,24,47,38,32,41,-1
01.11.2025,2025,por b,146,Sangalhos,x,86,83,19,21,23,23,21,17,23,22,40,46,38,45,1
01.11.2025,2025,por b,146,Santo Andre,x,89,71,19,20,24,26,19,13,27,12,39,50,32,39,-1
01.11.2025,2025,por b,146,Ginasio,x,77,78,24,23,20,12,10,21,23,22,47,32,31,45,1
01.11.2025,2025,por b,140,Lusitania,x,79,57,24,13,20,16,20,11,15,17,37,36,31,32,-1
03.11.2025,2025,sır,159,Zlatibor,Vojvodina Novi Sad,84,89,20,22,19,25,24,22,21,20,42,44,46,41,1
03.11.2025,2025,sır,154,Cacak 94,Mladost Zemun,71,78,19,21,20,15,16,18,16,24,40,35,34,40,-1
03.11.2025,2025,sır,162,Tamis,Vrsac,66,79,14,25,20,17,19,16,13,21,39,37,35,34,-1
03.11.2025,2025,sır,163,KK Mladost SP,OKK Novi Pazar,104,75,32,17,26,24,28,20,18,14,49,50,48,32,-1
03.11.2025,2025,sır,173,Dynamic,Joker,96,95,20,29,28,17,28,25,20,24,49,45,53,44,1
01.11.2025,2025,sır,170,OKK Beograd,Radnicki,79,81,19,27,17,16,24,22,19,16,46,33,46,35,-1
03.11.2025,2025,sır,166,Sloga,x,76,85,21,27,22,20,21,21,12,17,48,42,42,29,-1
03.11.2025,2025,sır,159,Vojvodina Novi Sad,x,84,89,20,22,19,25,24,22,21,20,42,44,46,41,1
03.11.2025,2025,sır,154,Mladost Zemun,x,71,78,19,21,20,15,16,18,16,24,40,35,34,40,-1
03.11.2025,2025,sır,162,Vrsac,x,66,79,14,25,20,17,19,16,13,21,39,37,35,34,-1
03.11.2025,2025,sır,163,OKK Novi Pazar,x,104,75,32,17,26,24,28,20,18,14,49,50,48,32,-1
03.11.2025,2025,sır,173,Joker,x,96,95,20,29,28,17,28,25,20,24,49,45,53,44,1
01.11.2025,2025,sır,170,Radnicki,x,79,81,19,27,17,16,24,22,19,16,46,33,46,35,-1
01.11.2025,2025,rus,151,Bars Rostov,Barnaul,70,76,17,14,10,23,24,16,19,23,31,33,40,42,1
01.11.2025,2025,rus,146,Dynamo Grozny,Chelyabinsk,78,74,17,15,21,13,20,19,20,27,32,34,39,47,1
01.11.2025,2025,rus,144,Khimki M.,Dome-Springs Izhevsk,64,75,19,21,16,16,16,15,13,23,40,32,31,36,-1
01.11.2025,2025,rus,155,Zenit Petersburg 2,Metallurg,80,77,18,19,16,18,23,13,23,27,37,34,36,50,1
01.11.2025,2025,rus,145,University-Ugra,Temp Sumz Revda,76,87,15,23,30,19,23,22,8,23,38,49,45,31,1
01.11.2025,2025,rus,154,Irkutsk,Tambov,81,66,14,16,14,12,21,19,32,19,30,26,40,51,1
01.11.2025,2025,rus,152,Dynamo Vladivostok,CSKA Moscow 2,86,90,27,21,20,26,25,20,14,23,48,46,45,37,1
29.10.2025,2025,rus,144,Bars Rostov,Novosibirsk,71,77,19,17,21,19,16,21,15,20,36,40,37,35,-1
29.10.2025,2025,rus,144,Dynamo Grozny,Metallurg,74,82,11,21,23,21,17,15,23,25,32,44,32,48,1
29.10.2025,2025,rus,151,Khimki M.,Temp Sumz Revda,71,81,19,17,21,22,18,22,13,20,36,43,40,33,-1
29.10.2025,2025,rus,153,Lokomotiv Kuban 2,Barnaul,57,80,16,22,7,19,17,23,17,16,38,26,40,33,-1
29.10.2025,2025,rus,148,Zenit Petersburg 2,Chelyabinsk,93,91,15,29,29,26,27,16,22,20,44,55,43,42,1
29.10.2025,2025,rus,,University-Ugra,Dome-Springs Izhevsk,65,55,17,15,14,11,14,9,20,20,32,25,23,40,
29.10.2025,2025,rus,149,Irkutsk,CSKA Moscow 2,80,91,12,25,23,25,26,18,19,23,37,48,44,42,1
29.10.2025,2025,rus,154,Dynamo Vladivostok,Tambov,85,79,24,23,15,14,20,19,17,20,47,29,39,37,-1
26.10.2025,2025,rus,147,Lokomotiv Kuban 2,Novosibirsk,79,85,12,23,24,15,16,24,27,23,35,39,40,50,1
01.11.2025,2025,rus,151,Barnaul,x,70,76,17,14,10,23,24,16,19,23,31,33,40,42,1
01.11.2025,2025,rus,146,Chelyabinsk,x,78,74,17,15,21,13,20,19,20,27,32,34,39,47,1
01.11.2025,2025,rus,144,Dome-Springs Izhevsk,x,64,75,19,21,16,16,16,15,13,23,40,32,31,36,-1
01.11.2025,2025,rus,155,Metallurg,x,80,77,18,19,16,18,23,13,23,27,37,34,36,50,1
01.11.2025,2025,rus,145,Temp Sumz Revda,x,76,87,15,23,30,19,23,22,8,23,38,49,45,31,1
01.11.2025,2025,rus,154,Tambov,x,81,66,14,16,14,12,21,19,32,19,30,26,40,51,1
01.11.2025,2025,rus,152,CSKA Moscow 2,x,86,90,27,21,20,26,25,20,14,23,48,46,45,37,1
29.10.2025,2025,rus,144,Novosibirsk,x,71,77,19,17,21,19,16,21,15,20,36,40,37,35,-1
29.10.2025,2025,rus,144,Metallurg,x,74,82,11,21,23,21,17,15,23,25,32,44,32,48,1
29.10.2025,2025,rus,151,Temp Sumz Revda,x,71,81,19,17,21,22,18,22,13,20,36,43,40,33,-1
29.10.2025,2025,rus,153,Barnaul,x,57,80,16,22,7,19,17,23,17,16,38,26,40,33,-1
29.10.2025,2025,rus,148,Chelyabinsk,x,93,91,15,29,29,26,27,16,22,20,44,55,43,42,1
29.10.2025,2025,rus,,Dome-Springs Izhevsk,x,65,55,17,15,14,11,14,9,20,20,32,25,23,40,
29.10.2025,2025,rus,149,CSKA Moscow 2,x,80,91,12,25,23,25,26,18,19,23,37,48,44,42,1
29.10.2025,2025,rus,154,Tambov,x,85,79,24,23,15,14,20,19,17,20,47,29,39,37,-1
26.10.2025,2025,rus,147,Novosibirsk,x,79,85,12,23,24,15,16,24,27,23,35,39,40,50,1
02.11.2025,2025,slovak,166,BC Komarno,Inter Bratislava,80,73,15,17,22,16,20,25,23,15,32,38,45,38,-1
02.11.2025,2025,slovak,163,BC Prievidza,Nitra Blue Wings,63,80,14,23,13,16,20,16,16,25,37,29,36,41,-1
02.11.2025,2025,slovak,175,BKM Lucenec,Spisski Rytieri,70,87,19,24,21,33,22,18,8,12,43,54,40,20,-1
02.11.2025,2025,slovak,162,Iskra Svit,Levice,68,94,17,15,19,26,20,23,12,30,32,45,43,42,1
02.11.2025,2025,slovak,160,MBK Handlova,SPU Nitra,91,51,31,11,22,17,21,11,17,12,42,39,32,29,-1
02.11.2025,2025,slovak,166,Inter Bratislava,x,80,73,15,17,22,16,20,25,23,15,32,38,45,38,-1
02.11.2025,2025,slovak,163,Nitra Blue Wings,x,63,80,14,23,13,16,20,16,16,25,37,29,36,41,-1
02.11.2025,2025,slovak,175,Spisski Rytieri,x,70,87,19,24,21,33,22,18,8,12,43,54,40,20,-1
02.11.2025,2025,slovak,162,Levice,x,68,94,17,15,19,26,20,23,12,30,32,45,43,42,1
02.11.2025,2025,slovak,160,SPU Nitra,x,91,51,31,11,22,17,21,11,17,12,42,39,32,29,-1
02.11.2025,2025,rom,150,Arges Pitesti,Petrolul Ploiesti,77,48,15,17,24,9,27,12,11,10,32,33,39,21,-1
02.11.2025,2025,rom,164,CSM Constanta,Voluntari,93,107,23,25,25,26,22,30,23,26,48,51,52,49,1
02.11.2025,2025,rom,153,Rapid Bucuresti,CSM Oradea,83,91,26,18,22,32,22,24,13,17,44,54,46,30,-1
02.11.2025,2025,rom,165,Dinamo Bucharest,Cluj-Napoca,93,88,29,24,21,21,23,27,20,16,53,42,50,36,1
02.11.2025,2025,rom,164,SCM Craiova,Municipal Galati,91,83,24,18,24,21,20,19,23,25,42,45,39,48,1
02.11.2025,2025,rom,150,Petrolul Ploiesti,x,77,48,15,17,24,9,27,12,11,10,32,33,39,21,-1
02.11.2025,2025,rom,164,Voluntari,x,93,107,23,25,25,26,22,30,23,26,48,51,52,49,1
02.11.2025,2025,rom,153,CSM Oradea,x,83,91,26,18,22,32,22,24,13,17,44,54,46,30,-1
02.11.2025,2025,rom,165,Cluj-Napoca,x,93,88,29,24,21,21,23,27,20,16,53,42,50,36,1
02.11.2025,2025,rom,164,Municipal Galati,x,91,83,24,18,24,21,20,19,23,25,42,45,39,48,1
02.11.2025,2025,swit,162,Geneva Lions,Fribourg Olympic,63,84,23,31,14,18,13,22,13,13,54,32,35,26,-1
02.11.2025,2025,swit,156,Regio Basel,Neuchatel,74,73,17,15,18,21,17,15,22,22,32,39,32,44,-1
02.11.2025,2025,swit,159,SAM Massagno,Sdent BBC Nyon,68,91,23,22,11,14,13,21,21,34,45,25,34,55,1
02.11.2025,2025,swit,162,BBC Monthey,Lugano Tigers,82,88,22,30,12,12,28,29,20,17,52,24,57,37,1
02.11.2025,2025,swit,162,Fribourg Olympic,x,63,84,23,31,14,18,13,22,13,13,54,32,35,26,-1
02.11.2025,2025,swit,156,Neuchatel,x,74,73,17,15,18,21,17,15,22,22,32,39,32,44,-1
02.11.2025,2025,swit,159,Sdent BBC Nyon,x,68,91,23,22,11,14,13,21,21,34,45,25,34,55,1
02.11.2025,2025,swit,162,Lugano Tigers,x,82,88,22,30,12,12,28,29,20,17,52,24,57,37,1
03.11.2025,2025,tur,164,Merkezefendi,Buyukcekmece,80,75,17,16,27,15,18,23,18,21,33,42,41,39,-1
03.11.2025,2025,tur,169,Fenerbahce,Petkim Spor,66,75,9,22,24,15,18,20,15,18,31,39,38,33,-1
03.11.2025,2025,tur,166,Tofas,Bursaspor,94,71,18,22,26,17,23,13,27,19,40,43,36,46,-1
03.11.2025,2025,tur,168,Anadolu Efes,Manisa,85,73,19,25,13,16,36,21,17,11,44,29,57,28,1
02.11.2025,2025,tur,160,Karsiyaka,Galatasaray,94,81,23,14,23,23,22,22,26,22,37,46,44,48,1
02.11.2025,2025,tur,160,Besiktas,Mersin SK,72,66,17,19,14,8,16,20,25,19,36,22,36,44,-1
02.11.2025,2025,tur,170,Turk Telekom,Darussafaka,105,68,26,22,22,17,24,11,33,18,48,39,35,51,1
01.11.2025,2025,tur,155,Bahcesehir Kol.,Yalovaspor,83,82,18,24,23,23,22,13,20,22,42,46,35,42,-1
04.11.2025,2025,tur b,157,Çağdaş Bodrum Spor,Cayirova,78,75,19,14,19,19,11,26,29,16,33,38,37,45,1
03.11.2025,2025,tur b,158,MKE Ankaragucu,Ankara Kolejliler,87,86,25,21,26,21,15,24,21,20,46,47,39,41,1
03.11.2025,2025,tur b,155,Konya BBSK,iLab Basketbol,88,91,21,18,25,26,16,23,26,24,39,51,39,50,1
03.11.2025,2025,tur b,160,Kapakli Spor,Esenler Erokspor,86,77,25,17,21,24,17,14,23,22,42,45,31,45,-1
02.11.2025,2025,tur b,154,Fenerbahce 2,OGM Ormanspor,79,76,22,20,19,30,15,17,23,9,42,49,32,32,-1
02.11.2025,2025,tur b,163,Balikesir,Gaziantep,82,87,25,23,17,18,23,27,17,19,48,35,50,36,1
02.11.2025,2025,tur b,160,Trabzonspor,Istanbul Anka Spor,114,65,30,13,21,15,35,23,28,14,43,36,58,42,1
02.11.2025,2025,tur b,153,Final Spor,Bordo Sportif,76,59,12,9,20,14,27,15,17,21,21,34,42,38,1
02.11.2025,2025,tur b,155,Harem Spor,CO Basket,88,90,28,8,19,23,22,27,11,22,36,42,49,33,1
03.11.2025,2025,tur,164,Buyukcekmece,x,80,75,17,16,27,15,18,23,18,21,33,42,41,39,-1
03.11.2025,2025,tur,169,Petkim Spor,x,66,75,9,22,24,15,18,20,15,18,31,39,38,33,-1
03.11.2025,2025,tur,166,Bursaspor,x,94,71,18,22,26,17,23,13,27,19,40,43,36,46,-1
03.11.2025,2025,tur,168,Manisa,x,85,73,19,25,13,16,36,21,17,11,44,29,57,28,1
02.11.2025,2025,tur,160,Galatasaray,x,94,81,23,14,23,23,22,22,26,22,37,46,44,48,1
02.11.2025,2025,tur,160,Mersin SK,x,72,66,17,19,14,8,16,20,25,19,36,22,36,44,-1
02.11.2025,2025,tur,170,Darussafaka,x,105,68,26,22,22,17,24,11,33,18,48,39,35,51,1
01.11.2025,2025,tur,155,Yalovaspor,x,83,82,18,24,23,23,22,13,20,22,42,46,35,42,-1
04.11.2025,2025,tur b,157,Cayirova,x,78,75,19,14,19,19,11,26,29,16,33,38,37,45,1
03.11.2025,2025,tur b,158,Ankara Kolejliler,x,87,86,25,21,26,21,15,24,21,20,46,47,39,41,1
03.11.2025,2025,tur b,155,iLab Basketbol,x,88,91,21,18,25,26,16,23,26,24,39,51,39,50,1
03.11.2025,2025,tur b,160,Esenler Erokspor,x,86,77,25,17,21,24,17,14,23,22,42,45,31,45,-1
02.11.2025,2025,tur b,154,OGM Ormanspor,x,79,76,22,20,19,30,15,17,23,9,42,49,32,32,-1
02.11.2025,2025,tur b,163,Gaziantep,x,82,87,25,23,17,18,23,27,17,19,48,35,50,36,1
02.11.2025,2025,tur b,160,Istanbul Anka Spor,x,114,65,30,13,21,15,35,23,28,14,43,36,58,42,1
02.11.2025,2025,tur b,153,Bordo Sportif,x,76,59,12,9,20,14,27,15,17,21,21,34,42,38,1
02.11.2025,2025,tur b,155,CO Basket,x,88,90,28,8,19,23,22,27,11,22,36,42,49,33,1
30.10.2025,2025,eurocup,156,JL Bourg,Aris,88,91,22,21,20,20,16,15,30,35,43,40,31,65,1
30.10.2025,2025,eurocup,168,Hapoel Tel-Aviv,Buducnost,92,72,17,22,29,16,28,17,18,17,39,45,45,35,-1
30.10.2025,2025,eurocup,166,Ulm,Trento,84,82,18,20,15,21,35,23,16,18,38,36,58,34,1
30.10.2025,2025,eurocup,160,Cedevita Olimpija,Hapoel Jerusalem,83,94,19,19,17,26,19,32,28,17,38,43,51,45,1
30.10.2025,2025,eurocup,167,Cluj-Napoca,Venezia,86,78,20,24,19,22,17,21,30,11,44,41,38,41,-1
30.10.2025,2025,eurocup,162,Bahcesehir Kol.,Trefl Sopot,79,67,15,15,28,12,10,19,26,21,30,40,29,47,-1
30.10.2025,2025,eurocup,159,Joventut Badalona,Gran Canaria,76,78,17,17,22,16,14,15,14,19,34,38,29,33,-1
29.10.2025,2025,eurocup,161,Hamburg,Turk Telekom,89,77,27,18,16,21,22,12,24,26,45,37,34,50,1
29.10.2025,2025,eurocup,166,BC Wolves,Besiktas,93,78,20,26,27,16,31,14,15,22,46,43,45,37,-1
30.10.2025,2025,eurocup,156,Aris,x,88,91,22,21,20,20,16,15,30,35,43,40,31,65,1
30.10.2025,2025,eurocup,168,Buducnost,x,92,72,17,22,29,16,28,17,18,17,39,45,45,35,-1
30.10.2025,2025,eurocup,166,Trento,x,84,82,18,20,15,21,35,23,16,18,38,36,58,34,1
30.10.2025,2025,eurocup,160,Hapoel Jerusalem,x,83,94,19,19,17,26,19,32,28,17,38,43,51,45,1
30.10.2025,2025,eurocup,167,Venezia,x,86,78,20,24,19,22,17,21,30,11,44,41,38,41,-1
30.10.2025,2025,eurocup,162,Trefl Sopot,x,79,67,15,15,28,12,10,19,26,21,30,40,29,47,-1
30.10.2025,2025,eurocup,159,Gran Canaria,x,76,78,17,17,22,16,14,15,14,19,34,38,29,33,-1
29.10.2025,2025,eurocup,161,Turk Telekom,x,89,77,27,18,16,21,22,12,24,26,45,37,34,50,1
29.10.2025,2025,eurocup,166,Besiktas,x,93,78,20,26,27,16,31,14,15,22,46,43,45,37,-1
30.10.2025,2025,champions,163,Manresa,Chemnitz,105,59,26,11,18,20,21,12,40,16,37,38,33,56,1
30.10.2025,2025,champions,155,Kolossos Rhodes,Karsiyaka,59,71,14,16,20,22,7,23,18,10,30,42,30,28,-1
30.10.2025,2025,champions,167,Rytas,Szombathely,103,83,28,18,21,18,24,27,30,20,46,39,51,50,1
30.10.2025,2025,champions,167,Maccabi Ironi Ramat Gan,Bonn,78,86,12,26,24,27,16,13,26,20,38,51,29,46,-1
29.10.2025,2025,champions,164,Benfica,Tortona,58,72,16,21,16,20,14,16,12,15,37,36,30,27,-1
29.10.2025,2025,champions,154,Saint Quentin,Tenerife,61,71,21,17,14,16,16,13,10,25,38,30,29,35,-1
29.10.2025,2025,champions,156,Slask Wroclaw,Reggiana,65,73,17,17,18,17,16,19,14,20,34,35,35,34,-1
29.10.2025,2025,champions,158,VEF Riga,AEK Athens,69,80,19,18,14,19,21,27,15,16,37,33,48,31,-1
31.10.2025,2025,fiba,160,Levice,Anorthosis,100,68,31,22,25,14,28,16,16,16,53,39,44,32,-1
30.10.2025,2025,fiba,154,Caledonia Gladiators,Ludwigsburg,73,71,18,22,11,18,19,20,25,11,40,29,39,36,-1
30.10.2025,2025,fiba,157,Sassari,Sporting CP,88,71,31,19,28,23,20,21,9,8,50,51,41,17,-1
30.10.2025,2025,fiba,164,Antwerp Giants,CSM Constanta,84,81,23,31,27,19,18,20,16,11,54,46,38,27,-1
30.10.2025,2025,fiba,153,PAOK,Limburg,94,76,23,15,28,18,19,22,24,21,38,46,41,45,1
30.10.2025,2025,fiba,164,Norrkoping,Maroussi,74,71,15,12,11,17,18,21,30,21,27,28,39,51,1
30.10.2025,2025,fiba,153,Spojnia Stargard,CSM Oradea,65,77,4,26,20,17,19,23,22,11,30,37,42,33,-1
30.10.2025,2025,fiba,161,Trepca,Dijon,84,89,28,22,10,25,21,25,25,17,50,35,46,42,1
30.10.2025,2025,fiba,172,Bursaspor,Basket Zaragoza,87,89,16,18,15,19,19,22,28,19,34,34,41,47,1
30.10.2025,2025,fiba,170,Keravnos,Tofas,96,99,26,24,25,20,24,29,21,26,50,45,53,47,1
30.10.2025,2025,fiba,158,AEK Larnaca,Basketball Braunschweig,63,72,14,20,17,23,20,10,12,19,34,40,30,31,-1
30.10.2025,2025,fiba,154,Balkan,Bilbao,62,93,15,21,17,26,18,26,12,20,36,43,44,32,-1
30.10.2025,2025,fiba,162,BC Dnipro,Anwil Wloclawek,63,100,9,27,23,17,14,35,17,21,36,40,49,38,1
30.10.2025,2025,fiba,150,Parnu,Arges Pitesti,73,70,16,18,21,21,23,15,13,16,34,42,38,29,-1
30.10.2025,2025,fiba,153,Szolnoki Olaj,FC Porto,71,88,20,21,17,20,16,26,18,21,41,37,42,39,1
30.10.2025,2025,fiba,161,Kutaisi,BC Prievidza,104,108,17,16,28,24,13,15,15,18,33,52,28,33,-1
30.10.2025,2025,fiba,153,Sabah Baku,Spirou Charleroi,68,78,24,22,17,16,14,18,13,22,46,33,32,35,-1
29.10.2025,2025,fiba,153,Le Portel,BC Kalev/Cramo,54,77,12,26,13,14,11,22,18,15,38,27,33,33,-1
29.10.2025,2025,fiba,164,Fribourg Olympic,Cholet,81,85,20,12,12,25,27,19,16,19,32,37,46,35,-1
29.10.2025,2025,fiba,176,Rilski Sportist,Alba Fehervar,83,93,17,24,17,22,27,17,22,30,41,39,44,52,1
30.10.2025,2025,champions,163,Chemnitz,x,105,59,26,11,18,20,21,12,40,16,37,38,33,56,1
30.10.2025,2025,champions,155,Karsiyaka,x,59,71,14,16,20,22,7,23,18,10,30,42,30,28,-1
30.10.2025,2025,champions,167,Szombathely,x,103,83,28,18,21,18,24,27,30,20,46,39,51,50,1
30.10.2025,2025,champions,167,Bonn,x,78,86,12,26,24,27,16,13,26,20,38,51,29,46,-1
29.10.2025,2025,champions,164,Tortona,x,58,72,16,21,16,20,14,16,12,15,37,36,30,27,-1
29.10.2025,2025,champions,154,Tenerife,x,61,71,21,17,14,16,16,13,10,25,38,30,29,35,-1
29.10.2025,2025,champions,156,Reggiana,x,65,73,17,17,18,17,16,19,14,20,34,35,35,34,-1
29.10.2025,2025,champions,158,AEK Athens,x,69,80,19,18,14,19,21,27,15,16,37,33,48,31,-1
31.10.2025,2025,fiba,160,Anorthosis,x,100,68,31,22,25,14,28,16,16,16,53,39,44,32,-1
30.10.2025,2025,fiba,154,Ludwigsburg,x,73,71,18,22,11,18,19,20,25,11,40,29,39,36,-1
30.10.2025,2025,fiba,157,Sporting CP,x,88,71,31,19,28,23,20,21,9,8,50,51,41,17,-1
30.10.2025,2025,fiba,164,CSM Constanta,x,84,81,23,31,27,19,18,20,16,11,54,46,38,27,-1
30.10.2025,2025,fiba,153,Limburg,x,94,76,23,15,28,18,19,22,24,21,38,46,41,45,1
30.10.2025,2025,fiba,164,Maroussi,x,74,71,15,12,11,17,18,21,30,21,27,28,39,51,1
30.10.2025,2025,fiba,153,CSM Oradea,x,65,77,4,26,20,17,19,23,22,11,30,37,42,33,-1
30.10.2025,2025,fiba,161,Dijon,x,84,89,28,22,10,25,21,25,25,17,50,35,46,42,1
30.10.2025,2025,fiba,172,Basket Zaragoza,x,87,89,16,18,15,19,19,22,28,19,34,34,41,47,1
30.10.2025,2025,fiba,170,Tofas,x,96,99,26,24,25,20,24,29,21,26,50,45,53,47,1
30.10.2025,2025,fiba,158,Basketball Braunschweig,x,63,72,14,20,17,23,20,10,12,19,34,40,30,31,-1
30.10.2025,2025,fiba,154,Bilbao,x,62,93,15,21,17,26,18,26,12,20,36,43,44,32,-1
30.10.2025,2025,fiba,162,Anwil Wloclawek,x,63,100,9,27,23,17,14,35,17,21,36,40,49,38,1
30.10.2025,2025,fiba,150,Arges Pitesti,x,73,70,16,18,21,21,23,15,13,16,34,42,38,29,-1
30.10.2025,2025,fiba,153,FC Porto,x,71,88,20,21,17,20,16,26,18,21,41,37,42,39,1
30.10.2025,2025,fiba,161,BC Prievidza,x,104,108,17,16,28,24,13,15,15,18,33,52,28,33,-1
30.10.2025,2025,fiba,153,Spirou Charleroi,x,68,78,24,22,17,16,14,18,13,22,46,33,32,35,-1
29.10.2025,2025,fiba,153,BC Kalev/Cramo,x,54,77,12,26,13,14,11,22,18,15,38,27,33,33,-1
29.10.2025,2025,fiba,164,Cholet,x,81,85,20,12,12,25,27,19,16,19,32,37,46,35,-1
29.10.2025,2025,fiba,176,Alba Fehervar,x,83,93,17,24,17,22,27,17,22,30,41,39,44,52,1
01.11.2025,2025,eurolig,170,Paris,Baskonia,67,65,18,16,20,19,19,13,10,17,34,39,32,27,-1
01.11.2025,2025,eurolig,160,Crvena zvezda,Panathinaikos,77,81,18,18,28,20,12,17,19,26,36,48,29,45,-1
01.11.2025,2025,eurolig,165,Lyon-Villeurbanne,Bayern,71,84,17,19,16,24,16,21,22,20,36,40,37,42,-1
01.11.2025,2025,eurolig,157,Zalgiris Kaunas,Monaco,63,62,20,11,14,14,9,18,20,19,31,28,27,39,-1
01.11.2025,2025,eurolig,162,Fenerbahce,Partizan,89,72,22,15,22,16,23,22,22,19,37,38,45,41,1
31.10.2025,2025,eurolig,158,Olimpia Milano,Virtus Bologna,99,90,21,14,23,21,22,32,33,23,35,44,54,56,1
31.10.2025,2025,eurolig,159,Olympiacos,Barcelona,95,74,21,17,23,19,21,14,30,24,38,42,35,54,1
31.10.2025,2025,eurolig,172,Maccabi Tel Aviv,Real Madrid,79,78,21,23,15,20,19,21,24,14,44,35,40,38,-1
31.10.2025,2025,eurolig,166,Alba Berlin,Anadolu Efes,70,86,19,25,16,26,17,17,18,18,44,42,34,36,-1
30.10.2025,2025,eurolig,163,Partizan,Monaco,74,79,21,23,12,23,23,15,18,18,44,35,38,36,-1
30.10.2025,2025,eurolig,164,Panathinaikos,Lyon-Villeurbanne,92,68,27,14,18,15,25,23,22,16,41,33,48,38,1
30.10.2025,2025,eurolig,152,Zalgiris Kaunas,Crvena zvezda,86,84,24,18,23,15,19,24,20,27,42,38,43,47,1
29.10.2025,2025,eurolig,160,Virtus Bologna,Bayern,84,87,25,19,8,21,27,28,24,19,44,29,55,43,1
29.10.2025,2025,eurolig,160,Baskonia,Olimpia Milano,88,83,20,21,32,24,15,18,21,20,41,56,33,41,-1
29.10.2025,2025,eurolig,162,Olympiacos,Real Madrid,79,69,17,21,19,13,20,25,23,10,38,32,45,33,-1
29.10.2025,2025,eurolig,167,Alba Berlin,Paris,83,92,26,16,18,21,19,28,20,27,42,39,47,47,1
29.10.2025,2025,eurolig,163,Fenerbahce,Maccabi Tel Aviv,84,82,16,21,22,19,20,27,26,15,37,41,47,41,1
29.10.2025,2025,eurolig,167,Anadolu Efes,Barcelona,88,97,26,29,25,26,15,21,22,21,55,51,36,43,-1
01.11.2025,2025,eurolig,170,Baskonia,x,67,65,18,16,20,19,19,13,10,17,34,39,32,27,-1
01.11.2025,2025,eurolig,160,Panathinaikos,x,77,81,18,18,28,20,12,17,19,26,36,48,29,45,-1
01.11.2025,2025,eurolig,165,Bayern,x,71,84,17,19,16,24,16,21,22,20,36,40,37,42,-1
01.11.2025,2025,eurolig,157,Monaco,x,63,62,20,11,14,14,9,18,20,19,31,28,27,39,-1
01.11.2025,2025,eurolig,162,Partizan,x,89,72,22,15,22,16,23,22,22,19,37,38,45,41,1
31.10.2025,2025,eurolig,158,Virtus Bologna,x,99,90,21,14,23,21,22,32,33,23,35,44,54,56,1
31.10.2025,2025,eurolig,159,Barcelona,x,95,74,21,17,23,19,21,14,30,24,38,42,35,54,1
31.10.2025,2025,eurolig,172,Real Madrid,x,79,78,21,23,15,20,19,21,24,14,44,35,40,38,-1
31.10.2025,2025,eurolig,166,Anadolu Efes,x,70,86,19,25,16,26,17,17,18,18,44,42,34,36,-1
30.10.2025,2025,eurolig,163,Monaco,x,74,79,21,23,12,23,23,15,18,18,44,35,38,36,-1
30.10.2025,2025,eurolig,164,Lyon-Villeurbanne,x,92,68,27,14,18,15,25,23,22,16,41,33,48,38,1
30.10.2025,2025,eurolig,152,Crvena zvezda,x,86,84,24,18,23,15,19,24,20,27,42,38,43,47,1
29.10.2025,2025,eurolig,160,Bayern,x,84,87,25,19,8,21,27,28,24,19,44,29,55,43,1
29.10.2025,2025,eurolig,160,Olimpia Milano,x,88,83,20,21,32,24,15,18,21,20,41,56,33,41,-1
29.10.2025,2025,eurolig,162,Real Madrid,x,79,69,17,21,19,13,20,25,23,10,38,32,45,33,-1
29.10.2025,2025,eurolig,167,Paris,x,83,92,26,16,18,21,19,28,20,27,42,39,47,47,1
29.10.2025,2025,eurolig,163,Maccabi Tel Aviv,x,84,82,16,21,22,19,20,27,26,15,37,41,47,41,1
29.10.2025,2025,eurolig,167,Barcelona,x,88,97,26,29,25,26,15,21,22,21,55,51,36,43,-1
06.11.2025,2025,kore,159,Mobis Phoebus,Seoul Knights,76,95,11,22,20,21,18,31,27,21,33,41,49,48,1
05.11.2025,2025,kore,154,KoGas,Suwon KT,82,74,24,28,15,19,18,21,25,6,52,34,39,31,-1
04.11.2025,2025,kore,155,Wonju DB,Goyang Sono,64,79,16,14,18,17,11,25,19,23,30,35,36,42,1
06.11.2025,2025,kore,159,Seoul Knights,x,76,95,11,22,20,21,18,31,27,21,33,41,49,48,1
05.11.2025,2025,kore,154,Suwon KT,x,82,74,24,28,15,19,18,21,25,6,52,34,39,31,-1
04.11.2025,2025,kore,155,Goyang Sono,x,64,79,16,14,18,17,11,25,19,23,30,35,36,42,1
06.11.2025,2025,rus cup,153,Zenit Petersburg 2,CSKA Moscow 2,96,82,21,22,17,31,25,14,33,15,43,48,39,48,1
06.11.2025,2025,rus cup,147,Dome-Springs Izhevsk,Chelyabinsk,71,76,15,18,17,24,20,12,19,22,33,41,32,41,-1
06.11.2025,2025,rus cup,150,Temp Sumz Revda,University-Ugra,87,84,20,27,17,17,22,24,28,16,47,34,46,44,1
06.11.2025,2025,rus cup,151,Barnaul,Tambov,69,89,19,32,16,15,9,19,25,23,51,31,28,48,1
06.11.2025,2025,rus cup,145,Novosibirsk,Dynamo Grozny,75,56,17,18,24,8,21,12,13,18,35,32,33,31,-1
06.11.2025,2025,rus cup,154,Irkutsk,Lokomotiv Kuban 2,72,76,13,17,27,20,12,17,20,22,30,47,29,42,-1
06.11.2025,2025,rus cup,153,CSKA Moscow 2,x,96,82,21,22,17,31,25,14,33,15,43,48,39,48,1
06.11.2025,2025,rus cup,147,Chelyabinsk,x,71,76,15,18,17,24,20,12,19,22,33,41,32,41,-1
06.11.2025,2025,rus cup,150,University-Ugra,x,87,84,20,27,17,17,22,24,28,16,47,34,46,44,1
06.11.2025,2025,rus cup,151,Tambov,x,69,89,19,32,16,15,9,19,25,23,51,31,28,48,1
06.11.2025,2025,rus cup,145,Dynamo Grozny,x,75,56,17,18,24,8,21,12,13,18,35,32,33,31,-1
06.11.2025,2025,rus cup,154,Lokomotiv Kuban 2,x,72,76,13,17,27,20,12,17,20,22,30,47,29,42,-1
06.11.2025,2025,fin,153,Karhu Basket,Bisons Loimaa,78,81,17,22,25,22,20,17,16,20,39,47,37,36,-1
06.11.2025,2025,fin,171,Kataja,Salon Vilpas,116,114,22,26,20,31,31,20,27,23,48,51,51,50,1
06.11.2025,2025,fin,166,Pyrinto Tampere,KTP Kotka Basket,91,89,17,24,22,21,28,20,24,24,41,43,48,48,1
06.11.2025,2025,fin,165,UU-Korihait Uusikaupunki,Kouvot Kouvola,64,58,24,23,17,15,15,12,8,8,47,32,27,16,-1
06.11.2025,2025,fin,163,BC Nokia,Honka,88,82,15,11,30,17,12,22,17,24,26,47,34,41,-1
05.11.2025,2025,fin,169,Helsinki Seagulls,Kobrat,107,92,30,25,27,19,29,14,21,34,55,46,43,55,1
06.11.2025,2025,fin,153,Bisons Loimaa,x,78,81,17,22,25,22,20,17,16,20,39,47,37,36,-1
06.11.2025,2025,fin,171,Salon Vilpas,x,116,114,22,26,20,31,31,20,27,23,48,51,51,50,1
06.11.2025,2025,fin,166,KTP Kotka Basket,x,91,89,17,24,22,21,28,20,24,24,41,43,48,48,1
06.11.2025,2025,fin,165,Kouvot Kouvola,x,64,58,24,23,17,15,15,12,8,8,47,32,27,16,-1
06.11.2025,2025,fin,163,Honka,x,88,82,15,11,30,17,12,22,17,24,26,47,34,41,-1
05.11.2025,2025,fin,169,Kobrat,x,107,92,30,25,27,19,29,14,21,34,55,46,43,55,1
08.11.2025,2025,avst,177,Sydney,South East Melbourne,74,69,14,22,18,14,17,20,25,13,36,32,37,38,-1
07.11.2025,2025,avst,168,Perth,Tasmania JackJumpers,88,82,27,27,20,24,21,14,20,17,54,44,35,37,-1
07.11.2025,2025,avst,178,Brisbane Bullets,Melbourne United,103,120,20,24,25,28,26,33,32,35,44,53,59,67,1
08.11.2025,2025,avst,177,South East Melbourne,x,74,69,14,22,18,14,17,20,25,13,36,32,37,38,-1
07.11.2025,2025,avst,168,Tasmania JackJumpers,x,88,82,27,27,20,24,21,14,20,17,54,44,35,37,-1
07.11.2025,2025,avst,178,Melbourne United,x,103,120,20,24,25,28,26,33,32,35,44,53,59,67,1
27.10.2025,2025,taiwan tpbl,190,New Taipei Kings,New Taipei CTBC DEA,98,99,21,27,29,17,25,38,23,17,48,46,63,40,1
27.10.2025,2025,taiwan tpbl,192,Kaohsiung Aquas,Taiwan Beer Leopards,88,87,16,29,25,16,21,14,26,28,45,41,35,54,-1
26.10.2025,2025,taiwan tpbl,188,New Taipei Kings,Hsinchu Jko Lioneers,122,93,31,32,38,16,28,26,25,19,63,54,54,44,1
26.10.2025,2025,taiwan tpbl,197,Kaohsiung Aquas,Taipei Taishin Mars,88,71,16,22,21,18,32,13,19,18,38,39,45,37,-1
20.10.2025,2025,taiwan tpbl,,Kaohsiung Aquas,Hsinchu Jko Lioneers,93,79,22,17,21,19,31,25,19,18,39,40,56,37,
20.10.2025,2025,taiwan tpbl,184,Formosa Dreamers,Taipei Taishin Mars,105,85,31,25,32,25,23,11,19,24,56,57,34,43,-1
19.10.2025,2025,taiwan tpbl,203,Kaohsiung Aquas,New Taipei Kings,78,88,17,19,24,24,21,25,16,20,36,48,46,36,-1
19.10.2025,2025,taiwan tpbl,198,Formosa Dreamers,New Taipei CTBC DEA,88,74,21,18,21,22,23,16,23,18,39,43,39,41,-1
27.10.2025,2025,taiwan tpbl,190,New Taipei CTBC DEA,x,98,99,21,27,29,17,25,38,23,17,48,46,63,40,1
27.10.2025,2025,taiwan tpbl,192,Taiwan Beer Leopards,x,88,87,16,29,25,16,21,14,26,28,45,41,35,54,-1
26.10.2025,2025,taiwan tpbl,188,Hsinchu Jko Lioneers,x,122,93,31,32,38,16,28,26,25,19,63,54,54,44,1
26.10.2025,2025,taiwan tpbl,197,Taipei Taishin Mars,x,88,71,16,22,21,18,32,13,19,18,38,39,45,37,-1
20.10.2025,2025,taiwan tpbl,,Hsinchu Jko Lioneers,x,93,79,22,17,21,19,31,25,19,18,39,40,56,37,
20.10.2025,2025,taiwan tpbl,184,Taipei Taishin Mars,x,105,85,31,25,32,25,23,11,19,24,56,57,34,43,-1
19.10.2025,2025,taiwan tpbl,203,New Taipei Kings,x,78,88,17,19,24,24,21,25,16,20,36,48,46,36,-1
19.10.2025,2025,taiwan tpbl,198,New Taipei CTBC DEA,x,88,74,21,18,21,22,23,16,23,18,39,43,39,41,-1
03.11.2025,2025,taiwan tpbl,180,Taipei Taishin Mars,Taiwan Beer Leopards,78,82,19,21,21,9,21,18,17,34,40,30,39,51,-1
03.11.2025,2025,taiwan tpbl,,New Taipei CTBC DEA,Formosa Dreamers,82,89,26,30,15,19,18,20,23,20,56,34,38,43,
02.11.2025,2025,taiwan tpbl,180,Taipei Taishin Mars,Hsinchu Jko Lioneers,76,79,11,31,23,8,28,26,14,14,42,31,54,28,-1
02.11.2025,2025,taiwan tpbl,180,New Taipei CTBC DEA,Kaohsiung Aquas,107,97,26,26,19,33,33,10,29,28,52,52,43,57,1
30.10.2025,2025,taiwan tpbl,184,New Taipei Kings,Formosa Dreamers,88,81,23,24,20,21,15,20,30,16,47,41,35,46,-1
03.11.2025,2025,taiwan tpbl,180,Taiwan Beer Leopards,x,78,82,19,21,21,9,21,18,17,34,40,30,39,51,-1
03.11.2025,2025,taiwan tpbl,,Formosa Dreamers,x,82,89,26,30,15,19,18,20,23,20,56,34,38,43,
02.11.2025,2025,taiwan tpbl,180,Hsinchu Jko Lioneers,x,76,79,11,31,23,8,28,26,14,14,42,31,54,28,-1
02.11.2025,2025,taiwan tpbl,180,Kaohsiung Aquas,x,107,97,26,26,19,33,33,10,29,28,52,52,43,57,1
30.10.2025,2025,taiwan tpbl,184,Formosa Dreamers,x,88,81,23,24,20,21,15,20,30,16,47,41,35,46,-1
10.11.2025,2025,kore,154,Seoul Knights,Goyang Sono,91,71,23,24,26,24,26,13,16,10,47,50,39,26,-1
10.11.2025,2025,kore,158,KoGas,Mobis Phoebus,64,67,23,7,14,15,14,24,13,21,30,29,38,34,-1
10.11.2025,2025,kore,151,Wonju DB,LG Sakers,73,51,25,8,9,17,17,18,22,8,33,26,35,30,-1
09.11.2025,2025,kore,153,Anyang JungKwanJang,Seoul Thunders,102,59,30,8,24,20,28,8,20,23,38,44,36,43,1
09.11.2025,2025,kore,159,Seoul Knights,KCC Egis,93,57,18,15,25,14,24,17,26,11,33,39,41,37,-1
09.11.2025,2025,kore,154,Suwon KT,LG Sakers,65,59,12,13,13,22,26,13,14,11,25,35,39,25,-1
08.11.2025,2025,kore,153,KoGas,Goyang Sono,99,65,25,15,29,11,17,28,28,11,40,40,45,39,1
08.11.2025,2025,kore,159,Mobis Phoebus,Wonju DB,79,70,21,15,11,14,25,18,22,23,36,25,43,45,1
07.11.2025,2025,kore,154,Anyang JungKwanJang,Suwon KT,74,73,25,16,23,15,11,26,15,16,41,38,37,31,-1
07.11.2025,2025,kore,154,Seoul Thunders,LG Sakers,80,79,22,24,17,19,17,24,24,12,46,36,41,36,-1
10.11.2025,2025,kore,154,Goyang Sono,x,91,71,23,24,26,24,26,13,16,10,47,50,39,26,-1
10.11.2025,2025,kore,158,Mobis Phoebus,x,64,67,23,7,14,15,14,24,13,21,30,29,38,34,-1
10.11.2025,2025,kore,151,LG Sakers,x,73,51,25,8,9,17,17,18,22,8,33,26,35,30,-1
09.11.2025,2025,kore,153,Seoul Thunders,x,102,59,30,8,24,20,28,8,20,23,38,44,36,43,1
09.11.2025,2025,kore,159,KCC Egis,x,93,57,18,15,25,14,24,17,26,11,33,39,41,37,-1
09.11.2025,2025,kore,154,LG Sakers,x,65,59,12,13,13,22,26,13,14,11,25,35,39,25,-1
08.11.2025,2025,kore,153,Goyang Sono,x,99,65,25,15,29,11,17,28,28,11,40,40,45,39,1
08.11.2025,2025,kore,159,Wonju DB,x,79,70,21,15,11,14,25,18,22,23,36,25,43,45,1
07.11.2025,2025,kore,154,Suwon KT,x,74,73,25,16,23,15,11,26,15,16,41,38,37,31,-1
07.11.2025,2025,kore,154,LG Sakers,x,80,79,22,24,17,19,17,24,24,12,46,36,41,36,-1
10.11.2025,2025,avst,174,South East Melbourne,Cairns Taipans,97,74,34,20,15,20,17,15,31,19,54,35,32,50,-1
09.11.2025,2025,avst,182,Melbourne United,Perth,106,97,31,29,20,36,32,12,23,20,60,56,44,43,-1
09.11.2025,2025,avst,163,Tasmania JackJumpers,New Zealand Breakers,83,64,20,27,25,14,19,3,19,20,47,39,22,39,-1
10.11.2025,2025,avst,186,Illawarra Hawks,x,93,79,26,22,24,19,26,26,17,12,48,43,52,29,-1
10.11.2025,2025,avst,174,Cairns Taipans,x,97,74,34,20,15,20,17,15,31,19,54,35,32,50,-1
09.11.2025,2025,avst,182,Perth,x,106,97,31,29,20,36,32,12,23,20,60,56,44,43,-1
09.11.2025,2025,avst,163,New Zealand Breakers,x,83,64,20,27,25,14,19,3,19,20,47,39,22,39,-1
10.11.2025,2025,aba,157,Mega Basket,Crvena zvezda,76,81,23,16,21,22,19,24,13,19,39,43,43,32,-1
09.11.2025,2025,aba,162,Cibona,Split,72,71,18,21,18,15,21,13,15,22,39,33,34,37,-1
09.11.2025,2025,aba,150,Zadar,Cedevita Olimpija,81,73,17,7,24,25,19,17,21,24,24,49,36,45,1
04.11.2025,2025,aba,164,Mornar Bar,Cibona,92,85,34,24,19,19,11,25,28,17,58,38,36,45,-1
04.11.2025,2025,aba,163,Crvena zvezda,Cedevita Olimpija,92,86,22,20,29,25,26,19,15,22,42,54,45,37,1
04.11.2025,2025,aba,162,Split,Subotica,71,91,24,27,21,27,9,23,17,14,51,48,32,31,-1
04.11.2025,2025,aba,163,FMP Beograd,Partizan,64,91,17,29,11,26,20,15,16,21,46,37,35,37,-1
10.11.2025,2025,aba,157,Crvena zvezda,x,76,81,23,16,21,22,19,24,13,19,39,43,43,32,-1
09.11.2025,2025,aba,162,Split,x,72,71,18,21,18,15,21,13,15,22,39,33,34,37,-1
09.11.2025,2025,aba,150,Cedevita Olimpija,x,81,73,17,7,24,25,19,17,21,24,24,49,36,45,1
04.11.2025,2025,aba,164,Cibona,x,92,85,34,24,19,19,11,25,28,17,58,38,36,45,-1
04.11.2025,2025,aba,163,Cedevita Olimpija,x,92,86,22,20,29,25,26,19,15,22,42,54,45,37,1
04.11.2025,2025,aba,162,Subotica,x,71,91,24,27,21,27,9,23,17,14,51,48,32,31,-1
04.11.2025,2025,aba,163,Partizan,x,64,91,17,29,11,26,20,15,16,21,46,37,35,37,-1
06.11.2025,2025,aba 2,159,Cedevita Junior,Tivat,80,55,26,17,22,18,20,10,12,10,43,40,30,22,-1
06.11.2025,2025,aba 2,154,Vojvodina Novi Sad,Sutjeska,105,84,29,26,24,23,27,20,25,15,55,47,47,40,1
05.11.2025,2025,aba 2,159,KK Bosna,Rabotnicki,84,58,25,16,21,5,23,21,15,16,41,26,44,31,-1
05.11.2025,2025,aba 2,144,Helios Domzale,MZT Skopje,68,67,16,15,23,11,11,22,18,19,31,34,33,37,-1
06.11.2025,2025,aba 2,159,Tivat,x,80,55,26,17,22,18,20,10,12,10,43,40,30,22,-1
06.11.2025,2025,aba 2,154,Sutjeska,x,105,84,29,26,24,23,27,20,25,15,55,47,47,40,1
05.11.2025,2025,aba 2,159,Rabotnicki,x,84,58,25,16,21,5,23,21,15,16,41,26,44,31,-1
05.11.2025,2025,aba 2,144,MZT Skopje,x,68,67,16,15,23,11,11,22,18,19,31,34,33,37,-1
09.11.2025,2025,bnxt,151,Leuven Bears,Oostende,77,91,21,23,18,28,17,25,21,15,44,46,42,36,1
09.11.2025,2025,bnxt,156,Mechelen,Belfius Mons,79,68,17,18,20,16,20,17,22,17,35,36,37,39,-1
09.11.2025,2025,bnxt,163,LWD Basket,BAL Weert,79,73,16,27,25,19,20,11,18,16,43,44,31,34,-1
09.11.2025,2025,bnxt,158,Feyenoord,Spirou Charleroi,102,92,23,25,28,25,28,21,23,21,48,53,49,44,1
09.11.2025,2025,bnxt,153,Den Helder,Okapi Aalst,64,96,16,25,21,24,8,30,19,17,41,45,38,36,-1
08.11.2025,2025,bnxt,163,Kortrijk,Leiden,108,74,24,21,27,17,24,25,33,11,45,44,49,44,1
08.11.2025,2025,bnxt,161,Limburg,Zwolle,85,73,24,21,22,16,22,13,17,23,45,38,35,40,-1
09.11.2025,2025,bnxt,151,Oostende,x,77,91,21,23,18,28,17,25,21,15,44,46,42,36,1
09.11.2025,2025,bnxt,156,Belfius Mons,x,79,68,17,18,20,16,20,17,22,17,35,36,37,39,-1
09.11.2025,2025,bnxt,163,BAL Weert,x,79,73,16,27,25,19,20,11,18,16,43,44,31,34,-1
09.11.2025,2025,bnxt,158,Spirou Charleroi,x,102,92,23,25,28,25,28,21,23,21,48,53,49,44,1
09.11.2025,2025,bnxt,153,Okapi Aalst,x,64,96,16,25,21,24,8,30,19,17,41,45,38,36,-1
08.11.2025,2025,bnxt,163,Leiden,x,108,74,24,21,27,17,24,25,33,11,45,44,49,44,1
08.11.2025,2025,bnxt,161,Zwolle,x,85,73,24,21,22,16,22,13,17,23,45,38,35,40,-1
09.11.2025,2025,rom,156,Arges Pitesti,CSM Constanta,95,82,24,15,12,23,36,22,23,22,39,35,58,45,1
09.11.2025,2025,rom,158,BC Steaua Bucuresti,Corona Brasov,90,62,24,19,23,17,25,10,18,16,43,40,35,34,-1
09.11.2025,2025,rom,161,Voluntari,Rapid Bucuresti,85,84,27,17,23,16,19,23,16,28,44,39,42,44,1
09.11.2025,2025,rom,165,Cluj-Napoca,CSU Sibiu,100,60,28,16,16,17,25,19,31,8,44,33,44,39,1
09.11.2025,2025,rom,158,CSM Oradea,Dinamo Bucharest,86,57,21,13,21,18,22,11,22,15,34,39,33,37,-1
08.11.2025,2025,rom,170,Petrolul Ploiesti,Municipal Galati,99,94,29,31,27,16,19,21,24,26,60,43,40,50,1
08.11.2025,2025,rom,150,SCM Timisoara,SCM Craiova,68,63,17,16,15,15,11,12,25,20,33,30,23,45,-1
04.11.2025,2025,rom,155,Corona Brasov,Valcea,98,87,29,19,21,22,20,25,28,21,48,43,45,49,1
04.11.2025,2025,rom,163,CSM Targu Mures,SCM Timisoara,81,77,20,26,20,16,18,20,23,15,46,36,38,38,-1
04.11.2025,2025,rom,157,CSU Sibiu,BC Steaua Bucuresti,91,69,23,25,17,19,25,15,26,10,48,36,40,36,-1
09.11.2025,2025,rom,156,CSM Constanta,x,95,82,24,15,12,23,36,22,23,22,39,35,58,45,1
09.11.2025,2025,rom,158,Corona Brasov,x,90,62,24,19,23,17,25,10,18,16,43,40,35,34,-1
09.11.2025,2025,rom,161,Rapid Bucuresti,x,85,84,27,17,23,16,19,23,16,28,44,39,42,44,1
09.11.2025,2025,rom,165,CSU Sibiu,x,100,60,28,16,16,17,25,19,31,8,44,33,44,39,1
09.11.2025,2025,rom,158,Dinamo Bucharest,x,86,57,21,13,21,18,22,11,22,15,34,39,33,37,-1
08.11.2025,2025,rom,170,Municipal Galati,x,99,94,29,31,27,16,19,21,24,26,60,43,40,50,1
08.11.2025,2025,rom,150,SCM Craiova,x,68,63,17,16,15,15,11,12,25,20,33,30,23,45,-1
04.11.2025,2025,rom,155,Valcea,x,98,87,29,19,21,22,20,25,28,21,48,43,45,49,1
04.11.2025,2025,rom,163,SCM Timisoara,x,81,77,20,26,20,16,18,20,23,15,46,36,38,38,-1
04.11.2025,2025,rom,157,BC Steaua Bucuresti,x,91,69,23,25,17,19,25,15,26,10,48,36,40,36,-1
10.11.2025,2025,aus,163,Swans Gmunden,Klosterneuburg Dukes,87,79,22,16,16,21,16,18,19,18,38,37,34,37,-1
10.11.2025,2025,aus,159,Furstenfeld,BBC Nord,78,93,27,30,17,16,20,21,14,26,57,33,41,40,1
09.11.2025,2025,aus,164,St. Polten,Wels,54,92,18,20,10,26,12,26,14,20,38,36,38,34,-1
09.11.2025,2025,aus,166,Kapfenberg Bulls,Vienna Basket,90,76,24,24,18,20,29,13,19,19,48,38,42,38,-1
09.11.2025,2025,aus,158,Oberwart Gunners,Graz UBSC,83,72,28,19,17,23,17,19,21,11,47,40,36,32,-1
10.11.2025,2025,aus,163,Klosterneuburg Dukes,x,87,79,22,16,16,21,16,18,19,18,38,37,34,37,-1
10.11.2025,2025,aus,159,BBC Nord,x,78,93,27,30,17,16,20,21,14,26,57,33,41,40,1
09.11.2025,2025,aus,164,Wels,x,54,92,18,20,10,26,12,26,14,20,38,36,38,34,-1
09.11.2025,2025,aus,166,Vienna Basket,x,90,76,24,24,18,20,29,13,19,19,48,38,42,38,-1
09.11.2025,2025,aus,158,Graz UBSC,x,83,72,28,19,17,23,17,19,21,11,47,40,36,32,-1
09.11.2025,2025,cro,157,Kvarner,Osijek,81,92,12,22,19,25,22,23,28,22,34,44,45,50,1
09.11.2025,2025,cro,152,Dubrovnik,Alkar,64,55,16,24,17,5,10,12,21,14,40,22,22,35,-1
08.11.2025,2025,cro,164,GKK Sibenka,Dinamo Zagreb,82,75,22,15,17,23,28,21,15,16,37,40,49,31,-1
04.11.2025,2025,cro,160,GKK Sibenka,Kvarner,80,64,27,19,21,21,21,15,11,9,46,42,36,20,-1
04.11.2025,2025,cro,150,Zadar,Dubrovnik,90,79,18,26,23,20,33,9,16,24,44,43,42,40,1
09.11.2025,2025,cro,157,Osijek,x,81,92,12,22,19,25,22,23,28,22,34,44,45,50,1
09.11.2025,2025,cro,152,Alkar,x,64,55,16,24,17,5,10,12,21,14,40,22,22,35,-1
08.11.2025,2025,cro,164,Dinamo Zagreb,x,82,75,22,15,17,23,28,21,15,16,37,40,49,31,-1
04.11.2025,2025,cro,160,Kvarner,x,80,64,27,19,21,21,21,15,11,9,46,42,36,20,-1
04.11.2025,2025,cro,150,Dubrovnik,x,90,79,18,26,23,20,33,9,16,24,44,43,42,40,1
09.11.2025,2025,sır,164,Vrsac,Zlatibor,84,82,19,14,28,23,14,21,23,24,33,51,35,47,-1
09.11.2025,2025,sır,154,Radnicki,Tamis,91,84,22,17,19,23,33,23,17,21,39,42,56,38,1
09.11.2025,2025,sır,156,Cacak 94,KK Mladost SP,95,70,20,13,25,16,29,21,21,20,33,41,50,41,1
08.11.2025,2025,sır,179,Joker,OKK Beograd,90,66,27,19,23,20,19,16,21,11,46,43,35,32,-1
08.11.2025,2025,sır,158,Mladost Zemun,Sloga,89,83,23,21,13,22,18,19,35,21,44,35,37,56,1
06.11.2025,2025,sır,157,Sloboda,BBK Radnicki,82,89,9,24,30,17,24,27,19,21,33,47,51,40,1
09.11.2025,2025,sır,164,Zlatibor,x,84,82,19,14,28,23,14,21,23,24,33,51,35,47,-1
09.11.2025,2025,sır,154,Tamis,x,91,84,22,17,19,23,33,23,17,21,39,42,56,38,1
09.11.2025,2025,sır,156,KK Mladost SP,x,95,70,20,13,25,16,29,21,21,20,33,41,50,41,1
08.11.2025,2025,sır,179,OKK Beograd,x,90,66,27,19,23,20,19,16,21,11,46,43,35,32,-1
08.11.2025,2025,sır,158,Sloga,x,89,83,23,21,13,22,18,19,35,21,44,35,37,56,1
06.11.2025,2025,sır,157,BBK Radnicki,x,82,89,9,24,30,17,24,27,19,21,33,47,51,40,1
10.11.2025,2025,bos,160,HKK Mostar,Promo,90,69,20,18,21,21,26,12,23,18,38,42,38,41,-1
09.11.2025,2025,bos,163,Mrkonjic Grad,Spars Ilidza,84,75,25,22,20,17,18,18,21,18,47,37,36,39,-1
09.11.2025,2025,bos,161,Radnicki Gorazde,Leotar Trebinje,71,55,17,21,18,15,22,13,14,6,38,33,35,20,-1
09.11.2025,2025,bos,162,Sloboda,Slavija,95,87,19,18,24,26,23,23,29,20,37,50,46,49,1
09.11.2025,2025,bos,162,KK Bosna,Jahorina,95,69,22,19,21,23,29,15,23,12,41,44,44,35,-1
09.11.2025,2025,bos,158,Orlovik,Siroki Brijeg,67,90,25,37,12,11,15,20,15,22,62,23,35,37,-1
08.11.2025,2025,bos,150,Borac Banja Luka,Posusje,94,69,17,8,35,17,16,30,26,14,25,52,46,40,1
10.11.2025,2025,bos,160,Promo,x,90,69,20,18,21,21,26,12,23,18,38,42,38,41,-1
09.11.2025,2025,bos,163,Spars Ilidza,x,84,75,25,22,20,17,18,18,21,18,47,37,36,39,-1
09.11.2025,2025,bos,161,Leotar Trebinje,x,71,55,17,21,18,15,22,13,14,6,38,33,35,20,-1
09.11.2025,2025,bos,162,Slavija,x,95,87,19,18,24,26,23,23,29,20,37,50,46,49,1
09.11.2025,2025,bos,162,Jahorina,x,95,69,22,19,21,23,29,15,23,12,41,44,44,35,-1
09.11.2025,2025,bos,158,Siroki Brijeg,x,67,90,25,37,12,11,15,20,15,22,62,23,35,37,-1
08.11.2025,2025,bos,150,Posusje,x,94,69,17,8,35,17,16,30,26,14,25,52,46,40,1
09.11.2025,2025,bos,165,Cherno More,Spartak Pleven,88,91,23,20,21,27,22,15,14,18,43,48,37,32,-1
09.11.2025,2025,bos,160,Balkan,Rilski Sportist,68,76,16,23,18,17,14,13,20,23,39,35,27,43,-1
08.11.2025,2025,bos,169,Minyor,Beroe,89,73,22,29,24,18,24,15,19,11,51,42,39,30,-1
04.11.2025,2025,bos,158,Minyor,Levski,81,80,16,21,22,17,17,19,26,23,37,39,36,49,1
09.11.2025,2025,bos,165,Spartak Pleven,x,88,91,23,20,21,27,22,15,14,18,43,48,37,32,-1
09.11.2025,2025,bos,160,Rilski Sportist,x,68,76,16,23,18,17,14,13,20,23,39,35,27,43,-1
08.11.2025,2025,bos,169,Beroe,x,89,73,22,29,24,18,24,15,19,11,51,42,39,30,-1
04.11.2025,2025,bos,158,Levski,x,81,80,16,21,22,17,17,19,26,23,37,39,36,49,1
10.11.2025,2025,cek,165,Usti n. Labem,Opava,107,73,23,17,36,24,24,15,24,17,40,60,39,41,-1
09.11.2025,2025,cek,165,Jindrichuv Hradec,USK Prague,83,86,15,15,23,18,20,24,15,16,30,41,44,31,-1
09.11.2025,2025,cek,167,Slavia Prague,Nymburk,67,78,18,15,30,19,12,19,7,25,33,49,31,32,-1
09.11.2025,2025,cek,167,NH Ostrava,Decin,96,101,27,26,21,17,21,26,27,32,53,38,47,59,1
09.11.2025,2025,cek,168,Pardubice,Olomoucko,80,77,15,20,24,28,17,21,24,8,35,52,38,32,-1
09.11.2025,2025,cek,165,Brno,Srsni Pisek,79,93,13,18,16,29,27,22,23,24,31,45,49,47,1
10.11.2025,2025,cek,165,Opava,x,107,73,23,17,36,24,24,15,24,17,40,60,39,41,-1
09.11.2025,2025,cek,165,USK Prague,x,83,86,15,15,23,18,20,24,15,16,30,41,44,31,-1
09.11.2025,2025,cek,167,Nymburk,x,67,78,18,15,30,19,12,19,7,25,33,49,31,32,-1
09.11.2025,2025,cek,167,Decin,x,96,101,27,26,21,17,21,26,27,32,53,38,47,59,1
09.11.2025,2025,cek,168,Olomoucko,x,80,77,15,20,24,28,17,21,24,8,35,52,38,32,-1
09.11.2025,2025,cek,165,Srsni Pisek,x,79,93,13,18,16,29,27,22,23,24,31,45,49,47,1
09.11.2025,2025,fin,167,Karhu Basket,Kataja,78,101,11,25,27,21,18,28,22,27,36,48,46,49,1
09.11.2025,2025,fin,161,Salon Vilpas,UU-Korihait Uusikaupunki,109,61,22,11,26,26,29,16,32,8,33,52,45,40,1
09.11.2025,2025,fin,159,Bisons Loimaa,Kobrat,96,71,21,13,20,23,30,17,25,18,34,43,47,43,1
08.11.2025,2025,fin,170,Honka,Helsinki Seagulls,78,101,15,35,31,25,8,23,24,18,50,56,31,42,-1
08.11.2025,2025,fin,161,Kouvot Kouvola,Pyrinto Tampere,67,91,10,16,25,21,16,32,16,22,26,46,48,38,1
09.11.2025,2025,fin,167,Kataja,x,78,101,11,25,27,21,18,28,22,27,36,48,46,49,1
09.11.2025,2025,fin,161,UU-Korihait Uusikaupunki,x,109,61,22,11,26,26,29,16,32,8,33,52,45,40,1
09.11.2025,2025,fin,159,Kobrat,x,96,71,21,13,20,23,30,17,25,18,34,43,47,43,1
08.11.2025,2025,fin,170,Helsinki Seagulls,x,78,101,15,35,31,25,8,23,24,18,50,56,31,42,-1
08.11.2025,2025,fin,161,Pyrinto Tampere,x,67,91,10,16,25,21,16,32,16,22,26,46,48,38,1
10.11.2025,2025,sloven,157,Ilirija,Tajfun Sentjur,92,70,12,16,25,14,24,21,31,19,28,39,45,50,1
10.11.2025,2025,sloven,150,Rogaska,KK Triglav Kranj,90,84,20,23,15,20,27,17,15,17,43,35,44,32,1
09.11.2025,2025,sloven,156,Sencur,Podcetrtek,75,76,24,26,17,20,15,19,19,11,50,37,34,30,-1
09.11.2025,2025,sloven,154,Zlatorog Lasko,Helios Domzale,67,70,15,23,19,19,12,18,21,10,38,38,30,31,-1
06.11.2025,2025,sloven,155,LTH Castings,KK Krka Novo mesto,69,88,13,27,13,19,20,23,23,19,40,32,43,42,1
04.11.2025,2025,sloven,156,Podcetrtek,Rogaska,75,70,18,13,16,29,20,9,21,19,31,45,29,40,-1
10.11.2025,2025,sloven,157,Tajfun Sentjur,x,92,70,12,16,25,14,24,21,31,19,28,39,45,50,1
10.11.2025,2025,sloven,150,KK Triglav Kranj,x,90,84,20,23,15,20,27,17,15,17,43,35,44,32,1
09.11.2025,2025,sloven,156,Podcetrtek,x,75,76,24,26,17,20,15,19,19,11,50,37,34,30,-1
09.11.2025,2025,sloven,154,Helios Domzale,x,67,70,15,23,19,19,12,18,21,10,38,38,30,31,-1
06.11.2025,2025,sloven,155,KK Krka Novo mesto,x,69,88,13,27,13,19,20,23,23,19,40,32,43,42,1
04.11.2025,2025,sloven,156,Rogaska,x,75,70,18,13,16,29,20,9,21,19,31,45,29,40,-1
10.11.2025,2025,fra,165,Lyon-Villeurbanne,Nanterre,109,103,37,13,15,22,24,35,33,33,50,37,59,66,1
10.11.2025,2025,fra,161,Monaco,Dijon,76,74,13,13,23,19,21,24,19,18,26,42,45,37,1
10.11.2025,2025,fra,164,Saint Quentin,Paris,65,97,22,25,14,20,16,32,13,20,47,34,48,33,-1
09.11.2025,2025,fra,155,La Rochelle,JL Bourg,78,86,20,22,20,30,17,19,21,15,42,50,36,36,-1
09.11.2025,2025,fra,165,Nancy,Gravelines-Dunkerque,80,63,18,14,22,18,27,16,13,15,32,40,43,28,-1
09.11.2025,2025,fra,165,Chalon/Saone,Le Mans,88,84,24,19,20,20,23,31,21,14,43,40,54,35,1
09.11.2025,2025,fra,159,Limoges,Cholet,69,75,18,20,16,16,12,26,23,13,38,32,38,36,-1
09.11.2025,2025,fra,163,Strasbourg,Le Portel,75,76,13,15,26,18,15,18,18,21,28,44,33,39,-1
08.11.2025,2025,fra b,159,Ada Blois,Pau-Orthez,102,105,23,21,24,24,24,23,18,21,44,48,47,39,1
08.11.2025,2025,fra b,162,Antibes,Poitiers,59,77,19,20,10,20,16,17,14,20,39,30,33,34,-1
08.11.2025,2025,fra b,163,ASA,Orleans,84,86,12,21,21,26,20,15,31,24,33,47,35,55,1
08.11.2025,2025,fra b,167,Chalons-Reims,Chartres,101,83,32,14,22,17,19,28,28,24,46,39,47,52,1
08.11.2025,2025,fra b,149,Hyeres-Toulon,Boulazac,74,93,19,25,21,27,15,22,19,19,44,48,37,38,1
08.11.2025,2025,fra b,168,St. Chamond,Denain-Voltaire,93,84,25,30,20,20,17,12,13,13,55,40,29,26,-1
08.11.2025,2025,fra b,173,Aix Maurienne,Roanne,92,81,26,23,24,23,22,19,20,16,49,47,41,36,-1
08.11.2025,2025,fra b,158,Caen,Rouen,73,90,20,28,19,24,17,17,17,21,48,43,34,38,-1
08.11.2025,2025,fra b,158,Evreux,Vichy,94,90,24,17,21,19,21,30,28,24,41,40,51,52,1
08.11.2025,2025,fra b,155,Nantes,Fos-sur-Mer,100,70,23,15,23,15,28,16,26,24,38,38,44,50,1
05.11.2025,2025,fra b,155,Hyeres-Toulon,Antibes,64,76,18,14,14,17,11,17,21,28,32,31,28,49,-1
05.11.2025,2025,fra b,166,Vichy,Aix Maurienne,64,73,17,21,15,15,8,24,24,13,38,30,32,37,-1
05.11.2025,2025,fra b,163,Chalons-Reims,Ada Blois,89,90,16,20,24,17,25,22,16,22,36,41,47,38,1
05.11.2025,2025,fra b,164,Chartres,Evreux,87,99,16,33,13,23,30,25,28,18,49,36,55,46,1
05.11.2025,2025,fra b,154,Fos-sur-Mer,Denain-Voltaire,74,72,21,22,19,18,23,16,11,16,43,37,39,27,-1
05.11.2025,2025,fra b,155,Pau-Orthez,Caen,76,85,20,18,20,22,18,20,18,25,38,42,38,43,1
05.11.2025,2025,fra b,169,Roanne,Poitiers,101,82,26,15,20,31,21,14,34,22,41,51,35,56,1
05.11.2025,2025,fra b,163,Rouen,ASA,84,93,29,25,18,21,20,27,17,20,54,39,47,37,1
10.11.2025,2025,fra,165,Nanterre,x,109,103,37,13,15,22,24,35,33,33,50,37,59,66,1
10.11.2025,2025,fra,161,Dijon,x,76,74,13,13,23,19,21,24,19,18,26,42,45,37,1
10.11.2025,2025,fra,164,Paris,x,65,97,22,25,14,20,16,32,13,20,47,34,48,33,-1
09.11.2025,2025,fra,155,JL Bourg,x,78,86,20,22,20,30,17,19,21,15,42,50,36,36,-1
09.11.2025,2025,fra,165,Gravelines-Dunkerque,x,80,63,18,14,22,18,27,16,13,15,32,40,43,28,-1
09.11.2025,2025,fra,165,Le Mans,x,88,84,24,19,20,20,23,31,21,14,43,40,54,35,1
09.11.2025,2025,fra,159,Cholet,x,69,75,18,20,16,16,12,26,23,13,38,32,38,36,-1
09.11.2025,2025,fra,163,Le Portel,x,75,76,13,15,26,18,15,18,18,21,28,44,33,39,-1
08.11.2025,2025,fra b,159,Pau-Orthez,x,102,105,23,21,24,24,24,23,18,21,44,48,47,39,1
08.11.2025,2025,fra b,162,Poitiers,x,59,77,19,20,10,20,16,17,14,20,39,30,33,34,-1
08.11.2025,2025,fra b,163,Orleans,x,84,86,12,21,21,26,20,15,31,24,33,47,35,55,1
08.11.2025,2025,fra b,167,Chartres,x,101,83,32,14,22,17,19,28,28,24,46,39,47,52,1
08.11.2025,2025,fra b,149,Boulazac,x,74,93,19,25,21,27,15,22,19,19,44,48,37,38,1
08.11.2025,2025,fra b,168,Denain-Voltaire,x,93,84,25,30,20,20,17,12,13,13,55,40,29,26,-1
08.11.2025,2025,fra b,173,Roanne,x,92,81,26,23,24,23,22,19,20,16,49,47,41,36,-1
08.11.2025,2025,fra b,158,Rouen,x,73,90,20,28,19,24,17,17,17,21,48,43,34,38,-1
08.11.2025,2025,fra b,158,Vichy,x,94,90,24,17,21,19,21,30,28,24,41,40,51,52,1
08.11.2025,2025,fra b,155,Fos-sur-Mer,x,100,70,23,15,23,15,28,16,26,24,38,38,44,50,1
05.11.2025,2025,fra b,155,Antibes,x,64,76,18,14,14,17,11,17,21,28,32,31,28,49,-1
05.11.2025,2025,fra b,166,Aix Maurienne,x,64,73,17,21,15,15,8,24,24,13,38,30,32,37,-1
05.11.2025,2025,fra b,163,Ada Blois,x,89,90,16,20,24,17,25,22,16,22,36,41,47,38,1
05.11.2025,2025,fra b,164,Evreux,x,87,99,16,33,13,23,30,25,28,18,49,36,55,46,1
05.11.2025,2025,fra b,154,Denain-Voltaire,x,74,72,21,22,19,18,23,16,11,16,43,37,39,27,-1
05.11.2025,2025,fra b,155,Caen,x,76,85,20,18,20,22,18,20,18,25,38,42,38,43,1
05.11.2025,2025,fra b,169,Poitiers,x,101,82,26,15,20,31,21,14,34,22,41,51,35,56,1
05.11.2025,2025,fra b,163,ASA,x,84,93,29,25,18,21,20,27,17,20,54,39,47,37,1
10.11.2025,2025,ger b,166,Munster,Dusseldorf,100,79,18,18,24,16,28,21,30,24,36,40,49,54,1
10.11.2025,2025,ger b,161,PS Karlsruhe,Bremerhaven,78,87,16,20,24,28,28,12,10,27,36,52,40,37,-1
10.11.2025,2025,ger b,163,Artland,Giessen,78,86,24,21,21,21,18,22,15,22,45,42,40,37,-1
10.11.2025,2025,ger b,165,Vechta 2,Bochum,91,101,27,24,24,31,21,14,19,32,51,55,35,51,1
10.11.2025,2025,ger b,163,Dresden,Trier,89,82,27,21,22,19,22,20,18,22,48,41,42,40,1
10.11.2025,2025,ger b,159,Jena,Kirchheim,87,77,26,20,19,25,19,16,23,16,46,44,35,39,-1
10.11.2025,2025,ger b,168,Phoenix Hagen,Crailsheim Merlins,84,77,24,24,22,16,11,17,27,20,48,38,28,47,-1
10.11.2025,2025,ger b,164,Bayreuth,Tubingen,98,102,19,21,33,27,20,31,26,23,40,60,51,49,1
08.11.2025,2025,ger b,166,Dusseldorf,Crailsheim Merlins,66,100,15,30,19,22,17,22,15,26,45,41,39,41,-1
08.11.2025,2025,ger b,160,Giessen,Jena,74,81,21,22,15,12,15,25,23,22,43,27,40,45,1
08.11.2025,2025,ger b,162,Kirchheim,Bremerhaven,89,72,12,18,28,21,25,11,24,22,30,49,36,46,1
08.11.2025,2025,ger b,162,Bochum,Artland,98,78,24,28,30,11,20,20,24,19,52,41,40,43,1
08.11.2025,2025,ger b,169,Phoenix Hagen,Vechta 2,89,88,22,24,20,22,30,22,17,20,46,42,52,37,1
08.11.2025,2025,ger b,156,Tubingen,PS Karlsruhe,81,78,21,21,24,22,19,19,17,16,42,46,38,33,-1
08.11.2025,2025,ger b,173,Bayreuth,Dresden,71,72,16,16,17,16,22,16,16,24,32,33,38,40,-1
08.11.2025,2025,ger b,157,Nurnberger,Trier,59,100,12,25,22,18,11,28,14,29,37,40,39,43,1
06.11.2025,2025,ger b,156,Koblenz,Munster,55,98,13,25,14,28,15,21,13,24,38,42,36,37,-1
10.11.2025,2025,ger,164,Chemnitz,Oldenburg,87,78,22,20,24,19,20,23,21,16,42,43,43,37,-1
10.11.2025,2025,ger,163,Rostock,Bonn,64,69,13,12,22,15,9,25,20,17,25,37,34,37,-1
10.11.2025,2025,ger,156,Wurzburg,Basketball Braunschweig,70,53,25,11,17,11,17,13,11,18,36,28,30,29,-1
09.11.2025,2025,ger,171,Gottingen,Heidelberg,73,95,20,23,17,18,18,21,18,33,43,35,39,51,1
09.11.2025,2025,ger,163,Alba Berlin,Ulm,96,88,22,22,25,22,22,27,27,17,44,47,49,44,1
08.11.2025,2025,ger,162,Vechta,Bamberg,101,98,23,21,27,30,31,27,20,20,44,57,58,40,1
10.11.2025,2025,ger b,166,Dusseldorf,x,100,79,18,18,24,16,28,21,30,24,36,40,49,54,1
10.11.2025,2025,ger b,161,Bremerhaven,x,78,87,16,20,24,28,28,12,10,27,36,52,40,37,-1
10.11.2025,2025,ger b,163,Giessen,x,78,86,24,21,21,21,18,22,15,22,45,42,40,37,-1
10.11.2025,2025,ger b,165,Bochum,x,91,101,27,24,24,31,21,14,19,32,51,55,35,51,1
10.11.2025,2025,ger b,163,Trier,x,89,82,27,21,22,19,22,20,18,22,48,41,42,40,1
10.11.2025,2025,ger b,159,Kirchheim,x,87,77,26,20,19,25,19,16,23,16,46,44,35,39,-1
10.11.2025,2025,ger b,168,Crailsheim Merlins,x,84,77,24,24,22,16,11,17,27,20,48,38,28,47,-1
10.11.2025,2025,ger b,164,Tubingen,x,98,102,19,21,33,27,20,31,26,23,40,60,51,49,1
08.11.2025,2025,ger b,166,Crailsheim Merlins,x,66,100,15,30,19,22,17,22,15,26,45,41,39,41,-1
08.11.2025,2025,ger b,160,Jena,x,74,81,21,22,15,12,15,25,23,22,43,27,40,45,1
08.11.2025,2025,ger b,162,Bremerhaven,x,89,72,12,18,28,21,25,11,24,22,30,49,36,46,1
08.11.2025,2025,ger b,162,Artland,x,98,78,24,28,30,11,20,20,24,19,52,41,40,43,1
08.11.2025,2025,ger b,169,Vechta 2,x,89,88,22,24,20,22,30,22,17,20,46,42,52,37,1
08.11.2025,2025,ger b,156,PS Karlsruhe,x,81,78,21,21,24,22,19,19,17,16,42,46,38,33,-1
08.11.2025,2025,ger b,173,Dresden,x,71,72,16,16,17,16,22,16,16,24,32,33,38,40,-1
08.11.2025,2025,ger b,157,Trier,x,59,100,12,25,22,18,11,28,14,29,37,40,39,43,1
06.11.2025,2025,ger b,156,Munster,x,55,98,13,25,14,28,15,21,13,24,38,42,36,37,-1
10.11.2025,2025,ger,164,Oldenburg,x,87,78,22,20,24,19,20,23,21,16,42,43,43,37,-1
10.11.2025,2025,ger,163,Bonn,x,64,69,13,12,22,15,9,25,20,17,25,37,34,37,-1
10.11.2025,2025,ger,156,Basketball Braunschweig,x,70,53,25,11,17,11,17,13,11,18,36,28,30,29,-1
09.11.2025,2025,ger,171,Heidelberg,x,73,95,20,23,17,18,18,21,18,33,43,35,39,51,1
09.11.2025,2025,ger,163,Ulm,x,96,88,22,22,25,22,22,27,27,17,44,47,49,44,1
08.11.2025,2025,ger,162,Bamberg,x,101,98,23,21,27,30,31,27,20,20,44,57,58,40,1
11.11.2025,2025,greek,154,AS Karditsas,Panionios,72,63,18,19,24,16,18,17,12,11,37,40,35,23,-1
10.11.2025,2025,greek,162,Olympiacos,Promitheas,106,66,24,18,28,7,31,24,23,17,42,35,55,40,1
10.11.2025,2025,greek,159,Panathinaikos,Peristeri,104,68,22,15,24,16,22,19,36,18,37,40,41,54,1
09.11.2025,2025,greek,152,Aris,Maroussi,72,74,14,24,18,17,21,13,19,20,38,35,34,39,-1
09.11.2025,2025,greek,163,Lavrio,PAOK,96,71,21,7,20,17,27,22,28,25,28,37,49,53,1
09.11.2025,2025,greek,153,AEK Athens,Kolossos Rhodes,86,75,26,21,21,17,17,16,22,21,47,38,33,43,-1
04.11.2025,2025,greek,156,Lavrio,Panionios,84,80,17,17,22,23,17,19,16,13,34,45,36,29,-1
11.11.2025,2025,greek,154,Panionios,x,72,63,18,19,24,16,18,17,12,11,37,40,35,23,-1
10.11.2025,2025,greek,162,Promitheas,x,106,66,24,18,28,7,31,24,23,17,42,35,55,40,1
10.11.2025,2025,greek,159,Peristeri,x,104,68,22,15,24,16,22,19,36,18,37,40,41,54,1
09.11.2025,2025,greek,152,Maroussi,x,72,74,14,24,18,17,21,13,19,20,38,35,34,39,-1
09.11.2025,2025,greek,163,PAOK,x,96,71,21,7,20,17,27,22,28,25,28,37,49,53,1
09.11.2025,2025,greek,153,Kolossos Rhodes,x,86,75,26,21,21,17,17,16,22,21,47,38,33,43,-1
04.11.2025,2025,greek,156,Panionios,x,84,80,17,17,22,23,17,19,16,13,34,45,36,29,-1
10.11.2025,2025,kıbrıs,164,Keravnos,AEK Larnaca,81,96,19,31,23,16,16,25,23,24,50,39,41,47,1
10.11.2025,2025,kıbrıs,166,AEL,Achilleas K.,88,59,24,20,16,17,21,10,27,12,44,33,31,39,-1
09.11.2025,2025,kıbrıs,169,Apollon,Anorthosis,85,99,21,32,27,16,19,31,18,20,53,43,50,38,1
08.11.2025,2025,kıbrıs,153,ETHA Engomi,Paralimni,75,80,17,25,24,21,21,15,13,19,42,45,36,32,-1
04.11.2025,2025,kıbrıs,167,Anorthosis,AEL,96,88,22,21,30,21,23,22,21,24,43,51,45,45,1
10.11.2025,2025,kıbrıs,164,AEK Larnaca,x,81,96,19,31,23,16,16,25,23,24,50,39,41,47,1
10.11.2025,2025,kıbrıs,166,Achilleas K.,x,88,59,24,20,16,17,21,10,27,12,44,33,31,39,-1
09.11.2025,2025,kıbrıs,169,Anorthosis,x,85,99,21,32,27,16,19,31,18,20,53,43,50,38,1
08.11.2025,2025,kıbrıs,153,Paralimni,x,75,80,17,25,24,21,21,15,13,19,42,45,36,32,-1
04.11.2025,2025,kıbrıs,167,AEL,x,96,88,22,21,30,21,23,22,21,24,43,51,45,45,1
10.11.2025,2025,rus,154,CSKA Moscow 2,Dynamo Grozny,85,74,19,15,23,21,22,19,21,19,34,44,41,40,1
10.11.2025,2025,rus,155,Tambov,Zenit Petersburg 2,81,88,18,28,13,15,25,22,25,23,46,28,47,48,1
10.11.2025,2025,rus,152,Temp Sumz Revda,Bars Rostov,89,77,24,18,19,21,26,21,20,17,42,40,47,37,1
10.11.2025,2025,rus,148,Metallurg,University-Ugra,77,72,19,28,27,10,18,18,13,16,47,37,36,29,-1
10.11.2025,2025,rus,149,Irkutsk,Barnaul,68,76,19,16,12,21,16,20,21,19,35,33,36,40,1
10.11.2025,2025,rus,152,Dynamo Vladivostok,Novosibirsk,96,73,22,22,22,14,22,17,30,20,44,36,39,50,1
10.11.2025,2025,rus,154,Dynamo Grozny,x,85,74,19,15,23,21,22,19,21,19,34,44,41,40,1
10.11.2025,2025,rus,155,Zenit Petersburg 2,x,81,88,18,28,13,15,25,22,25,23,46,28,47,48,1
10.11.2025,2025,rus,152,Bars Rostov,x,89,77,24,18,19,21,26,21,20,17,42,40,47,37,1
10.11.2025,2025,rus,148,University-Ugra,x,77,72,19,28,27,10,18,18,13,16,47,37,36,29,-1
10.11.2025,2025,rus,149,Barnaul,x,68,76,19,16,12,21,16,20,21,19,35,33,36,40,1
10.11.2025,2025,rus,152,Novosibirsk,x,96,73,22,22,22,14,22,17,30,20,44,36,39,50,1
10.11.2025,2025,lat-st,155,Viimsi,BK Ogre,53,70,14,14,14,17,10,25,15,14,28,31,35,29,-1
09.11.2025,2025,lat-st,157,Rigas Zelli,Parnu,89,76,18,17,23,20,20,17,28,22,35,43,37,50,1
09.11.2025,2025,lat-st,162,Keila KK,VEF Riga,78,90,27,25,17,17,13,25,21,23,52,34,38,44,1
08.11.2025,2025,lat-st,152,BK Liepaja,Latvijas Universitate,78,71,24,23,11,15,21,13,22,20,47,26,34,42,-1
08.11.2025,2025,lat-st,158,Valmiera Glass Via,Keila Coolbet,93,89,17,23,29,22,21,16,26,28,40,51,37,54,1
08.11.2025,2025,lat-st,158,Tal Tech,Tartu Ulikool,67,84,19,22,10,21,12,21,26,20,41,31,33,46,-1
06.11.2025,2025,lat-st,166,Viimsi,Ventspils,89,94,23,18,13,23,26,25,27,28,41,36,51,55,1
05.11.2025,2025,lat-st,155,VEF Riga,BK Liepaja,74,58,22,27,18,7,22,4,12,20,49,25,26,32,-1
05.11.2025,2025,lat-st,163,Rapla,Ventspils,110,104,22,22,24,23,19,20,20,20,44,47,39,40,-1
10.11.2025,2025,lat lkl,175,Juventus,Jonava,79,80,24,22,27,19,17,23,11,16,46,46,40,27,-1
10.11.2025,2025,lat lkl,167,Neptunas,Zalgiris Kaunas,70,97,19,28,19,25,12,23,20,21,47,44,35,41,-1
09.11.2025,2025,lat lkl,175,Nevezis,BC Wolves,85,90,26,22,25,18,16,23,18,27,48,43,39,45,-1
09.11.2025,2025,lat lkl,174,Rytas,Mazeikiai,109,98,22,25,33,27,36,17,18,29,47,60,53,47,1
09.11.2025,2025,lat lkl,172,Siauliai,Lietkabelis,96,92,33,22,22,24,19,23,22,23,55,46,42,45,1
12.11.2025,2025,lat nkl,170,Jurbarkas,Vytis VDU,86,77,18,10,22,20,27,21,19,26,28,42,48,45,1
09.11.2025,2025,lat nkl,168,Jurbarkas,Rytas 2,77,71,15,15,22,13,16,15,24,28,30,35,31,52,-1
09.11.2025,2025,lat nkl,160,Alytaus Alytus,Ukmerges Stekas,77,87,13,33,26,18,11,18,27,18,46,44,29,45,-1
09.11.2025,2025,lat nkl,149,Plunges Olimpas,Neptunas 2,84,74,22,17,32,24,17,13,13,20,39,56,30,33,-1
09.11.2025,2025,lat nkl,155,Silute,BC Olimpas Palanga,74,77,22,26,9,16,22,12,21,23,48,25,34,44,1
09.11.2025,2025,lat nkl,166,Suduva-Mantinga,Vilkaviskis,72,66,23,21,13,15,17,14,19,16,44,28,31,35,-1
09.11.2025,2025,lat nkl,171,Vytis VDU,Omega-Tauras,77,81,22,18,20,16,21,31,14,16,40,36,52,30,-1
09.11.2025,2025,lat nkl,162,Zalgiris Kaunas 2,Delikatesas Joniskis,86,64,25,25,19,15,19,15,23,9,50,34,34,32,-1
07.11.2025,2025,lat nkl,158,BC Olimpas Palanga,Vilkaviskis,84,74,20,17,26,13,18,18,20,26,37,39,36,46,1
07.11.2025,2025,lat nkl,164,Rytas 2,Zalgiris Kaunas 2,81,69,24,25,17,22,24,10,16,12,49,39,34,28,-1
07.11.2025,2025,lat nkl,155,Ukmerges Stekas,Silute,75,69,23,17,15,14,14,15,23,23,40,29,29,46,-1
07.11.2025,2025,lat nkl,161,Delikatesas Joniskis,Plunges Olimpas,79,91,22,23,20,19,21,28,16,21,45,39,49,37,1
07.11.2025,2025,lat nkl,168,Neptunas 2,Vytis VDU,90,87,21,24,23,23,21,18,15,15,45,46,39,30,-1
07.11.2025,2025,lat nkl,158,Omega-Tauras,Kretinga,94,88,16,22,20,12,25,25,33,29,38,32,50,62,1
07.11.2025,2025,lat nkl,162,Suduva-Mantinga,Jurbarkas,89,78,19,24,23,17,26,15,21,22,43,40,41,43,1
05.11.2025,2025,lat nkl,166,Vytis VDU,Jurbarkas,89,82,19,27,14,18,25,23,31,14,46,32,48,45,1
05.11.2025,2025,lat nkl,160,Telsiai,Alytaus Alytus,90,88,24,20,23,17,22,29,21,22,44,40,51,43,1
10.11.2025,2025,lat-st,155,BK Ogre,x,53,70,14,14,14,17,10,25,15,14,28,31,35,29,-1
09.11.2025,2025,lat-st,157,Parnu,x,89,76,18,17,23,20,20,17,28,22,35,43,37,50,1
09.11.2025,2025,lat-st,162,VEF Riga,x,78,90,27,25,17,17,13,25,21,23,52,34,38,44,1
08.11.2025,2025,lat-st,152,Latvijas Universitate,x,78,71,24,23,11,15,21,13,22,20,47,26,34,42,-1
08.11.2025,2025,lat-st,158,Keila Coolbet,x,93,89,17,23,29,22,21,16,26,28,40,51,37,54,1
08.11.2025,2025,lat-st,158,Tartu Ulikool,x,67,84,19,22,10,21,12,21,26,20,41,31,33,46,-1
06.11.2025,2025,lat-st,166,Ventspils,x,89,94,23,18,13,23,26,25,27,28,41,36,51,55,1
05.11.2025,2025,lat-st,155,BK Liepaja,x,74,58,22,27,18,7,22,4,12,20,49,25,26,32,-1
05.11.2025,2025,lat-st,163,Ventspils,x,110,104,22,22,24,23,19,20,20,20,44,47,39,40,-1
10.11.2025,2025,lat lkl,175,Jonava,x,79,80,24,22,27,19,17,23,11,16,46,46,40,27,-1
10.11.2025,2025,lat lkl,167,Zalgiris Kaunas,x,70,97,19,28,19,25,12,23,20,21,47,44,35,41,-1
09.11.2025,2025,lat lkl,175,BC Wolves,x,85,90,26,22,25,18,16,23,18,27,48,43,39,45,-1
09.11.2025,2025,lat lkl,174,Mazeikiai,x,109,98,22,25,33,27,36,17,18,29,47,60,53,47,1
09.11.2025,2025,lat lkl,172,Lietkabelis,x,96,92,33,22,22,24,19,23,22,23,55,46,42,45,1
12.11.2025,2025,lat nkl,170,Vytis VDU,x,86,77,18,10,22,20,27,21,19,26,28,42,48,45,1
09.11.2025,2025,lat nkl,168,Rytas 2,x,77,71,15,15,22,13,16,15,24,28,30,35,31,52,-1
09.11.2025,2025,lat nkl,160,Ukmerges Stekas,x,77,87,13,33,26,18,11,18,27,18,46,44,29,45,-1
09.11.2025,2025,lat nkl,149,Neptunas 2,x,84,74,22,17,32,24,17,13,13,20,39,56,30,33,-1
09.11.2025,2025,lat nkl,155,BC Olimpas Palanga,x,74,77,22,26,9,16,22,12,21,23,48,25,34,44,1
09.11.2025,2025,lat nkl,166,Vilkaviskis,x,72,66,23,21,13,15,17,14,19,16,44,28,31,35,-1
09.11.2025,2025,lat nkl,171,Omega-Tauras,x,77,81,22,18,20,16,21,31,14,16,40,36,52,30,-1
09.11.2025,2025,lat nkl,162,Delikatesas Joniskis,x,86,64,25,25,19,15,19,15,23,9,50,34,34,32,-1
07.11.2025,2025,lat nkl,158,Vilkaviskis,x,84,74,20,17,26,13,18,18,20,26,37,39,36,46,1
07.11.2025,2025,lat nkl,164,Zalgiris Kaunas 2,x,81,69,24,25,17,22,24,10,16,12,49,39,34,28,-1
07.11.2025,2025,lat nkl,155,Silute,x,75,69,23,17,15,14,14,15,23,23,40,29,29,46,-1
07.11.2025,2025,lat nkl,161,Plunges Olimpas,x,79,91,22,23,20,19,21,28,16,21,45,39,49,37,1
07.11.2025,2025,lat nkl,168,Vytis VDU,x,90,87,21,24,23,23,21,18,15,15,45,46,39,30,-1
07.11.2025,2025,lat nkl,158,Kretinga,x,94,88,16,22,20,12,25,25,33,29,38,32,50,62,1
07.11.2025,2025,lat nkl,162,Jurbarkas,x,89,78,19,24,23,17,26,15,21,22,43,40,41,43,1
05.11.2025,2025,lat nkl,166,Jurbarkas,x,89,82,19,27,14,18,25,23,31,14,46,32,48,45,1
05.11.2025,2025,lat nkl,160,Alytaus Alytus,x,90,88,24,20,23,17,22,29,21,22,44,40,51,43,1
10.11.2025,2025,ita,160,Sassari,Pistoia,77,75,15,21,14,16,32,18,16,20,36,30,50,36,1
10.11.2025,2025,ita,185,Varese,Virtus Bologna,104,95,24,22,27,22,25,30,28,21,46,49,55,49,1
10.11.2025,2025,ita,174,Trapani,Basket Napoli,95,85,24,22,31,23,8,20,32,20,46,54,28,52,-1
10.11.2025,2025,ita,159,Cremona,Brescia,89,100,21,25,20,29,26,31,22,15,46,49,57,37,1
10.11.2025,2025,ita,169,Treviso,Scafati,104,75,26,17,9,28,35,14,34,16,43,37,49,50,1
10.11.2025,2025,ita,158,Olimpia Milano,Venezia,79,78,24,20,20,12,22,17,13,29,44,32,39,42,1
09.11.2025,2025,ita,171,Trento,Trieste,76,68,23,19,23,6,14,25,16,18,42,29,39,34,-1
09.11.2025,2025,ita,155,Reggiana,Tortona,86,82,31,20,18,22,18,20,19,20,51,40,38,39,-1
06.11.2025,2025,ita,161,Virtus Bologna,Tortona,85,81,12,18,32,22,25,18,16,23,30,54,43,39,1
10.11.2025,2025,ita,160,Pistoia,x,77,75,15,21,14,16,32,18,16,20,36,30,50,36,1
10.11.2025,2025,ita,185,Virtus Bologna,x,104,95,24,22,27,22,25,30,28,21,46,49,55,49,1
10.11.2025,2025,ita,174,Basket Napoli,x,95,85,24,22,31,23,8,20,32,20,46,54,28,52,-1
10.11.2025,2025,ita,159,Brescia,x,89,100,21,25,20,29,26,31,22,15,46,49,57,37,1
10.11.2025,2025,ita,169,Scafati,x,104,75,26,17,9,28,35,14,34,16,43,37,49,50,1
10.11.2025,2025,ita,158,Venezia,x,79,78,24,20,20,12,22,17,13,29,44,32,39,42,1
09.11.2025,2025,ita,171,Trieste,x,76,68,23,19,23,6,14,25,16,18,42,29,39,34,-1
09.11.2025,2025,ita,155,Tortona,x,86,82,31,20,18,22,18,20,19,20,51,40,38,39,-1
06.11.2025,2025,ita,161,Tortona,x,85,81,12,18,32,22,25,18,16,23,30,54,43,39,1
10.11.2025,2025,ita b,150,Forli,Orzinuovi,87,82,23,22,19,15,15,16,18,22,45,34,31,40,-1
10.11.2025,2025,ita b,148,Avellino Basket,Libertas Livorno,84,68,17,12,18,15,34,15,15,26,29,33,49,41,1
10.11.2025,2025,ita b,146,Brindisi,Udine,89,81,23,20,29,19,17,20,20,22,43,48,37,42,1
10.11.2025,2025,ita b,155,Cento,Assigeco Piacenza,67,53,9,8,20,21,15,16,23,8,17,41,31,31,-1
10.11.2025,2025,ita b,147,Fortitudo Bologna,Basket Torino,79,82,22,13,15,18,21,15,18,30,35,33,36,48,1
10.11.2025,2025,ita b,154,Pesaro,Rimini,76,82,12,21,17,18,24,18,23,25,33,35,42,48,1
10.11.2025,2025,ita b,154,Verona,Nardo,86,76,21,11,25,15,23,24,17,26,32,40,47,43,1
10.11.2025,2025,ita b,151,Vigevano,Cantu,89,85,17,13,25,28,25,17,22,27,30,53,42,49,1
09.11.2025,2025,ita b,158,Urania Milano,JuVi Cremona,83,79,22,19,24,22,17,23,20,15,41,46,40,35,-1
09.11.2025,2025,ita b,148,Cividale,Sebastiani Rieti,77,63,16,22,11,17,25,14,25,10,38,28,39,35,-1
06.11.2025,2025,ita b,156,Rimini,Cento,80,77,15,26,21,9,20,12,24,30,41,30,32,54,1
06.11.2025,2025,ita b,148,Sebastiani Rieti,Fortitudo Bologna,61,60,9,14,19,19,15,14,18,13,23,38,29,31,-1
06.11.2025,2025,ita b,151,Libertas Livorno,Cividale,62,66,18,15,11,15,12,16,21,20,33,26,28,41,-1
06.11.2025,2025,ita b,156,Assigeco Piacenza,Nardo,93,75,21,22,22,16,24,19,26,18,43,38,43,44,1
06.11.2025,2025,ita b,147,Basket Torino,Forli,67,92,12,20,14,24,20,22,21,26,32,38,42,47,1
06.11.2025,2025,ita b,149,Cantu,Avellino Basket,83,71,18,15,23,14,14,24,28,18,33,37,38,46,1
06.11.2025,2025,ita b,149,JuVi Cremona,Brindisi,81,97,23,30,18,31,18,20,22,16,53,49,38,38,1
06.11.2025,2025,ita b,159,Orzinuovi,Urania Milano,79,86,27,18,17,25,13,21,22,22,45,42,34,44,-1
06.11.2025,2025,ita b,150,Udine,Pesaro,83,72,16,18,16,23,24,22,27,9,34,39,46,36,1
06.11.2025,2025,ita b,151,Verona,Vigevano,96,69,24,16,23,15,26,18,23,20,40,38,44,43,1
10.11.2025,2025,ita b,150,Orzinuovi,x,87,82,23,22,19,15,15,16,18,22,45,34,31,40,-1
10.11.2025,2025,ita b,148,Libertas Livorno,x,84,68,17,12,18,15,34,15,15,26,29,33,49,41,1
10.11.2025,2025,ita b,146,Udine,x,89,81,23,20,29,19,17,20,20,22,43,48,37,42,1
10.11.2025,2025,ita b,155,Assigeco Piacenza,x,67,53,9,8,20,21,15,16,23,8,17,41,31,31,-1
10.11.2025,2025,ita b,147,Basket Torino,x,79,82,22,13,15,18,21,15,18,30,35,33,36,48,1
10.11.2025,2025,ita b,154,Rimini,x,76,82,12,21,17,18,24,18,23,25,33,35,42,48,1
10.11.2025,2025,ita b,154,Nardo,x,86,76,21,11,25,15,23,24,17,26,32,40,47,43,1
10.11.2025,2025,ita b,151,Cantu,x,89,85,17,13,25,28,25,17,22,27,30,53,42,49,1
09.11.2025,2025,ita b,158,JuVi Cremona,x,83,79,22,19,24,22,17,23,20,15,41,46,40,35,-1
09.11.2025,2025,ita b,148,Sebastiani Rieti,x,77,63,16,22,11,17,25,14,25,10,38,28,39,35,-1
06.11.2025,2025,ita b,156,Cento,x,80,77,15,26,21,9,20,12,24,30,41,30,32,54,1
06.11.2025,2025,ita b,148,Fortitudo Bologna,x,61,60,9,14,19,19,15,14,18,13,23,38,29,31,-1
06.11.2025,2025,ita b,151,Cividale,x,62,66,18,15,11,15,12,16,21,20,33,26,28,41,-1
06.11.2025,2025,ita b,156,Nardo,x,93,75,21,22,22,16,24,19,26,18,43,38,43,44,1
06.11.2025,2025,ita b,147,Forli,x,67,92,12,20,14,24,20,22,21,26,32,38,42,47,1
06.11.2025,2025,ita b,149,Avellino Basket,x,83,71,18,15,23,14,14,24,28,18,33,37,38,46,1
06.11.2025,2025,ita b,149,Brindisi,x,81,97,23,30,18,31,18,20,22,16,53,49,38,38,1
06.11.2025,2025,ita b,159,Urania Milano,x,79,86,27,18,17,25,13,21,22,22,45,42,34,44,-1
06.11.2025,2025,ita b,150,Pesaro,x,83,72,16,18,16,23,24,22,27,9,34,39,46,36,1
06.11.2025,2025,ita b,151,Vigevano,x,96,69,24,16,23,15,26,18,23,20,40,38,44,43,1
10.11.2025,2025,mac,157,DEAC,Zalakeramia,68,62,19,14,16,16,14,15,19,17,33,32,29,36,-1
09.11.2025,2025,mac,166,Atomeromu Paks,Szolnoki Olaj,110,77,25,13,30,18,29,18,26,28,38,48,47,54,1
09.11.2025,2025,mac,155,Soproni KC,Budapesti Honved Se,81,64,20,18,14,13,23,19,24,14,38,27,42,38,1
09.11.2025,2025,mac,165,Kormend,KTE-Duna,82,80,12,17,32,27,22,18,16,18,29,59,40,34,-1
09.11.2025,2025,mac,167,NKA Pecs,Szombathely,61,86,19,21,21,23,17,19,4,23,40,44,36,27,-1
09.11.2025,2025,mac,177,OSE Lions,Alba Fehervar,97,93,26,30,21,19,24,25,26,19,56,40,49,45,1
08.11.2025,2025,mac,167,Szedeak,Pecsi VSK,78,77,25,14,25,27,13,17,15,19,39,52,30,34,-1
05.11.2025,2025,mac,158,NKA Pecs,DEAC,68,80,16,34,22,19,20,16,10,11,50,41,36,21,-1
10.11.2025,2025,mac,157,Zalakeramia,x,68,62,19,14,16,16,14,15,19,17,33,32,29,36,-1
09.11.2025,2025,mac,166,Szolnoki Olaj,x,110,77,25,13,30,18,29,18,26,28,38,48,47,54,1
09.11.2025,2025,mac,155,Budapesti Honved Se,x,81,64,20,18,14,13,23,19,24,14,38,27,42,38,1
09.11.2025,2025,mac,165,KTE-Duna,x,82,80,12,17,32,27,22,18,16,18,29,59,40,34,-1
09.11.2025,2025,mac,167,Szombathely,x,61,86,19,21,21,23,17,19,4,23,40,44,36,27,-1
09.11.2025,2025,mac,177,Alba Fehervar,x,97,93,26,30,21,19,24,25,26,19,56,40,49,45,1
08.11.2025,2025,mac,167,Pecsi VSK,x,78,77,25,14,25,27,13,17,15,19,39,52,30,34,-1
05.11.2025,2025,mac,158,DEAC,x,68,80,16,34,22,19,20,16,10,11,50,41,36,21,-1
11.11.2025,2025,mak,152,Rabotnicki,TFT Skopje,77,85,17,17,21,22,22,27,17,19,34,43,49,36,1
11.11.2025,2025,mak,152,MZT Skopje,Gostivar,96,90,19,10,18,22,24,21,24,32,29,40,45,56,1
09.11.2025,2025,mak,162,Cair 2030,Vardar,104,80,26,7,32,23,24,25,22,25,33,55,49,47,1
09.11.2025,2025,mak,160,Kozuv,MKK Kumanovo,82,74,16,20,34,21,14,18,18,15,36,55,32,33,-1
09.11.2025,2025,mak,162,Shkupi Skopje,Tikvesh,85,82,16,16,25,24,23,16,21,26,32,49,39,47,1
08.11.2025,2025,mak,160,Pelister,Feniks 2010,110,93,24,26,35,20,21,27,30,20,50,55,48,50,1
11.11.2025,2025,mak,152,TFT Skopje,x,77,85,17,17,21,22,22,27,17,19,34,43,49,36,1
11.11.2025,2025,mak,152,Gostivar,x,96,90,19,10,18,22,24,21,24,32,29,40,45,56,1
09.11.2025,2025,mak,162,Vardar,x,104,80,26,7,32,23,24,25,22,25,33,55,49,47,1
09.11.2025,2025,mak,160,MKK Kumanovo,x,82,74,16,20,34,21,14,18,18,15,36,55,32,33,-1
09.11.2025,2025,mak,162,Tikvesh,x,85,82,16,16,25,24,23,16,21,26,32,49,39,47,1
08.11.2025,2025,mak,160,Feniks 2010,x,110,93,24,26,35,20,21,27,30,20,50,55,48,50,1
10.11.2025,2025,pol,156,Legia,Spojnia Stargard,88,84,24,18,16,20,16,21,24,21,42,36,37,45,1
10.11.2025,2025,pol,166,Dabrowa Gornicza,Szczecin,88,92,17,28,30,23,21,19,20,22,45,53,40,42,-1
09.11.2025,2025,pol,167,Slask Wroclaw,Lublin,87,77,19,17,25,15,18,24,25,21,36,40,42,46,1
09.11.2025,2025,pol,171,Gdynia,Zielona Gora,83,92,20,11,20,32,25,28,18,21,31,52,53,39,1
08.11.2025,2025,pol,168,Trefl Sopot,Anwil Wloclawek,93,108,30,22,24,32,22,26,17,28,52,56,48,45,1
08.11.2025,2025,pol,149,Gornik Walbrzych,Czarni Slupsk,66,64,15,12,21,11,14,16,16,25,27,32,30,41,-1
07.11.2025,2025,pol,163,GTK Gliwice,Dziki Warszawa,64,76,18,16,19,20,13,24,14,16,34,39,37,30,-1
07.11.2025,2025,pol,166,Torun,Ostrow Wielkopolski,90,83,17,29,30,16,12,14,31,24,46,46,26,55,-1
10.11.2025,2025,pol,156,Spojnia Stargard,x,88,84,24,18,16,20,16,21,24,21,42,36,37,45,1
10.11.2025,2025,pol,166,Szczecin,x,88,92,17,28,30,23,21,19,20,22,45,53,40,42,-1
09.11.2025,2025,pol,167,Lublin,x,87,77,19,17,25,15,18,24,25,21,36,40,42,46,1
09.11.2025,2025,pol,171,Zielona Gora,x,83,92,20,11,20,32,25,28,18,21,31,52,53,39,1
08.11.2025,2025,pol,168,Anwil Wloclawek,x,93,108,30,22,24,32,22,26,17,28,52,56,48,45,1
08.11.2025,2025,pol,149,Czarni Slupsk,x,66,64,15,12,21,11,14,16,16,25,27,32,30,41,-1
07.11.2025,2025,pol,163,Dziki Warszawa,x,64,76,18,16,19,20,13,24,14,16,34,39,37,30,-1
07.11.2025,2025,pol,166,Ostrow Wielkopolski,x,90,83,17,29,30,16,12,14,31,24,46,46,26,55,-1
10.11.2025,2025,por,156,Ovarense,Sporting CP,77,86,22,19,26,22,7,26,22,19,41,48,33,41,-1
10.11.2025,2025,por,159,Esgueira,Benfica,85,93,19,19,23,27,17,25,26,22,38,50,42,48,1
09.11.2025,2025,por,154,FC Porto,Oliveirense,98,95,21,20,21,27,23,23,33,25,41,48,46,58,1
09.11.2025,2025,por,149,Galitos Barreiro,CD Povoa,75,77,24,21,13,23,18,12,20,21,45,36,30,41,-1
09.11.2025,2025,por,156,Galomar,Imortal,75,72,29,23,13,12,19,11,14,26,52,25,30,40,-1
10.11.2025,2025,por b,141,Portimonense,CAB Madeira,70,90,14,26,13,21,25,14,18,29,40,34,39,47,1
10.11.2025,2025,por b,147,Galitos Aveiro,Maia,77,82,20,11,18,23,18,22,21,26,31,41,40,47,1
09.11.2025,2025,por b,140,Lusitania,Barreirense,70,56,21,14,25,10,11,13,13,19,35,35,24,32,-1
09.11.2025,2025,por b,159,Vasco Da Gama,Ginasio,109,92,31,19,26,26,27,20,25,27,50,52,47,52,1
09.11.2025,2025,por b,152,Sangalhos,Braga,55,79,13,23,18,18,14,23,10,15,36,36,37,25,-1
09.11.2025,2025,por b,139,Santo Andre,Benfica Lisboa B,70,59,19,20,18,18,19,15,14,6,39,36,34,20,-1
09.11.2025,2025,por b,147,Sampaense,Illiabum,56,94,9,12,18,25,21,38,8,19,21,43,59,27,1
10.11.2025,2025,por,156,Sporting CP,x,77,86,22,19,26,22,7,26,22,19,41,48,33,41,-1
10.11.2025,2025,por,159,Benfica,x,85,93,19,19,23,27,17,25,26,22,38,50,42,48,1
09.11.2025,2025,por,154,Oliveirense,x,98,95,21,20,21,27,23,23,33,25,41,48,46,58,1
09.11.2025,2025,por,149,CD Povoa,x,75,77,24,21,13,23,18,12,20,21,45,36,30,41,-1
09.11.2025,2025,por,156,Imortal,x,75,72,29,23,13,12,19,11,14,26,52,25,30,40,-1
10.11.2025,2025,por b,141,CAB Madeira,x,70,90,14,26,13,21,25,14,18,29,40,34,39,47,1
10.11.2025,2025,por b,147,Maia,x,77,82,20,11,18,23,18,22,21,26,31,41,40,47,1
09.11.2025,2025,por b,140,Barreirense,x,70,56,21,14,25,10,11,13,13,19,35,35,24,32,-1
09.11.2025,2025,por b,159,Ginasio,x,109,92,31,19,26,26,27,20,25,27,50,52,47,52,1
09.11.2025,2025,por b,152,Braga,x,55,79,13,23,18,18,14,23,10,15,36,36,37,25,-1
09.11.2025,2025,por b,139,Benfica Lisboa B,x,70,59,19,20,18,18,19,15,14,6,39,36,34,20,-1
09.11.2025,2025,por b,147,Illiabum,x,56,94,9,12,18,25,21,38,8,19,21,43,59,27,1
09.11.2025,2025,slovak,164,BKM Lucenec,Levice,77,89,15,19,20,22,23,19,19,29,34,42,42,48,1
09.11.2025,2025,slovak,156,Iskra Svit,MBK Handlova,88,85,24,17,28,18,16,19,20,31,41,46,35,51,1
09.11.2025,2025,slovak,170,BC Komarno,Spisski Rytieri,94,73,27,13,18,22,30,17,19,21,40,40,47,40,1
09.11.2025,2025,slovak,165,SPU Nitra,Nitra Blue Wings,76,106,20,24,10,29,16,20,30,33,44,39,36,63,1
09.11.2025,2025,slovak,164,BC Prievidza,Inter Bratislava,81,83,19,15,20,22,23,25,19,21,34,42,48,40,1
09.11.2025,2025,slovak,164,Levice,x,77,89,15,19,20,22,23,19,19,29,34,42,42,48,1
09.11.2025,2025,slovak,156,MBK Handlova,x,88,85,24,17,28,18,16,19,20,31,41,46,35,51,1
09.11.2025,2025,slovak,170,Spisski Rytieri,x,94,73,27,13,18,22,30,17,19,21,40,40,47,40,1
09.11.2025,2025,slovak,165,Nitra Blue Wings,x,76,106,20,24,10,29,16,20,30,33,44,39,36,63,1
09.11.2025,2025,slovak,164,Inter Bratislava,x,81,83,19,15,20,22,23,25,19,21,34,42,48,40,1
12.11.2025,2025,swit,154,Geneva Lions,Neuchatel,80,73,21,25,19,13,19,23,21,12,46,32,42,33,-1
09.11.2025,2025,swit,163,Fribourg Olympic,SAM Massagno,107,76,30,18,26,20,23,12,28,26,48,46,35,54,1
09.11.2025,2025,swit,158,Lausanne Basket,Regio Basel,86,64,15,14,27,15,23,18,21,17,29,42,41,38,-1
09.11.2025,2025,swit,160,Sdent BBC Nyon,BBC Monthey,69,72,20,22,25,17,14,24,10,9,42,42,38,19,-1
09.11.2025,2025,swit,161,Lugano Tigers,Geneva Lions,63,98,20,20,20,35,7,18,16,25,40,55,25,41,-1
12.11.2025,2025,swit,154,Neuchatel,x,80,73,21,25,19,13,19,23,21,12,46,32,42,33,-1
09.11.2025,2025,swit,163,SAM Massagno,x,107,76,30,18,26,20,23,12,28,26,48,46,35,54,1
09.11.2025,2025,swit,158,Regio Basel,x,86,64,15,14,27,15,23,18,21,17,29,42,41,38,-1
09.11.2025,2025,swit,160,BBC Monthey,x,69,72,20,22,25,17,14,24,10,9,42,42,38,19,-1
09.11.2025,2025,swit,161,Geneva Lions,x,63,98,20,20,20,35,7,18,16,25,40,55,25,41,-1
11.11.2025,2025,tur,165,Yalovaspor,Merkezefendi,90,76,22,24,18,19,29,19,21,14,46,37,48,35,1
10.11.2025,2025,tur,165,Manisa,Fenerbahce,82,90,21,24,20,24,21,26,20,16,45,44,47,36,1
10.11.2025,2025,tur,170,Mersin SK,Anadolu Efes,76,94,20,24,13,27,22,20,21,23,44,40,42,44,1
10.11.2025,2025,tur,168,Bursaspor,Bahcesehir Kol.,92,80,21,21,18,22,26,23,27,14,42,40,49,41,1
09.11.2025,2025,tur,163,Galatasaray,Besiktas,91,88,25,27,21,19,18,25,27,17,52,40,43,44,1
09.11.2025,2025,tur,160,Petkim Spor,Turk Telekom,68,75,19,20,14,27,14,14,21,14,39,41,28,35,-1
09.11.2025,2025,tur,168,Darussafaka,Tofas,78,87,15,21,21,25,22,20,20,21,36,46,42,41,-1
09.11.2025,2025,tur,166,Buyukcekmece,Karsiyaka,75,82,15,22,14,8,25,24,21,28,37,22,49,49,1
11.11.2025,2025,tur b,158,Esenler Erokspor,Trabzonspor,74,77,20,22,20,19,12,21,22,15,42,39,33,37,-1
10.11.2025,2025,tur b,164,Cayirova,Kapakli Spor,107,83,27,19,31,28,27,19,22,17,46,59,46,39,1
10.11.2025,2025,tur b,154,OGM Ormanspor,Çağdaş Bodrum Spor,93,88,29,21,20,25,20,17,24,25,50,45,37,49,1
10.11.2025,2025,tur b,165,Istanbul Anka Spor,MKE Ankaragucu,71,90,18,28,17,14,14,20,22,28,46,31,34,50,1
09.11.2025,2025,tur b,151,iLab Basketbol,Final Spor,89,78,23,20,18,14,20,26,28,18,43,32,46,46,1
09.11.2025,2025,tur b,155,Ankara Kolejliler,Konya BBSK,82,86,22,19,21,22,18,23,21,22,41,43,41,43,1
09.11.2025,2025,tur b,159,Gaziantep,Fenerbahce 2,80,82,21,27,24,19,19,16,16,20,48,43,35,36,-1
09.11.2025,2025,tur b,158,CO Basket,Balikesir,80,89,19,31,14,19,22,18,25,21,50,33,40,46,1
08.11.2025,2025,tur b,155,Bordo Sportif,Harem Spor,64,85,14,27,18,17,18,21,14,20,41,35,39,34,-1
11.11.2025,2025,tur,165,Merkezefendi,x,90,76,22,24,18,19,29,19,21,14,46,37,48,35,1
10.11.2025,2025,tur,165,Fenerbahce,x,82,90,21,24,20,24,21,26,20,16,45,44,47,36,1
10.11.2025,2025,tur,170,Anadolu Efes,x,76,94,20,24,13,27,22,20,21,23,44,40,42,44,1
10.11.2025,2025,tur,168,Bahcesehir Kol.,x,92,80,21,21,18,22,26,23,27,14,42,40,49,41,1
09.11.2025,2025,tur,163,Besiktas,x,91,88,25,27,21,19,18,25,27,17,52,40,43,44,1
09.11.2025,2025,tur,160,Turk Telekom,x,68,75,19,20,14,27,14,14,21,14,39,41,28,35,-1
09.11.2025,2025,tur,168,Tofas,x,78,87,15,21,21,25,22,20,20,21,36,46,42,41,-1
09.11.2025,2025,tur,166,Karsiyaka,x,75,82,15,22,14,8,25,24,21,28,37,22,49,49,1
11.11.2025,2025,tur b,158,Trabzonspor,x,74,77,20,22,20,19,12,21,22,15,42,39,33,37,-1
10.11.2025,2025,tur b,164,Kapakli Spor,x,107,83,27,19,31,28,27,19,22,17,46,59,46,39,1
10.11.2025,2025,tur b,154,Çağdaş Bodrum Spor,x,93,88,29,21,20,25,20,17,24,25,50,45,37,49,1
10.11.2025,2025,tur b,165,MKE Ankaragucu,x,71,90,18,28,17,14,14,20,22,28,46,31,34,50,1
09.11.2025,2025,tur b,151,Final Spor,x,89,78,23,20,18,14,20,26,28,18,43,32,46,46,1
09.11.2025,2025,tur b,155,Konya BBSK,x,82,86,22,19,21,22,18,23,21,22,41,43,41,43,1
09.11.2025,2025,tur b,159,Fenerbahce 2,x,80,82,21,27,24,19,19,16,16,20,48,43,35,36,-1
09.11.2025,2025,tur b,158,Balikesir,x,80,89,19,31,14,19,22,18,25,21,50,33,40,46,1
08.11.2025,2025,tur b,155,Harem Spor,x,64,85,14,27,18,17,18,21,14,20,41,35,39,34,-1
12.11.2025,2025,ukr,150,Cherkaski Mavpy,BK Zaporozhye,68,64,18,10,17,23,16,16,17,15,28,40,32,32,-1
11.11.2025,2025,ukr,148,Cherkaski Mavpy,BC Dnipro,74,77,13,16,22,15,19,26,20,20,29,37,45,40,1
11.11.2025,2025,ukr,139,Kryvbas,BK Zaporozhye,73,75,26,17,21,15,11,23,15,20,43,36,34,35,-1
06.11.2025,2025,ukr,145,BC Dnipro,Stariy Lutsk,76,64,27,19,16,12,15,13,18,20,46,28,28,38,-1
06.11.2025,2025,ukr,142,BK Zaporozhye,Rivne,66,70,13,20,18,14,15,17,20,19,33,32,32,39,-1
05.11.2025,2025,ukr,146,BC Dnipro,Rivne,85,48,20,16,18,7,26,7,21,18,36,25,33,39,-1
05.11.2025,2025,ukr,141,BK Zaporozhye,Stariy Lutsk,65,66,20,17,18,13,11,22,16,14,37,31,33,30,-1
01.11.2025,2025,ukr,147,Kyiv Basket,Goverla,82,63,24,16,17,20,20,14,21,13,40,37,34,34,-1
01.11.2025,2025,ukr,145,Kryvbas,Cherkaski Mavpy,84,81,18,19,19,21,15,30,32,11,37,40,45,43,1
31.10.2025,2025,ukr,146,Cherkaski Mavpy,Kryvbas,72,64,20,22,22,19,15,13,15,10,42,41,28,25,-1
31.10.2025,2025,ukr,146,Goverla,Kyiv Basket,74,77,20,23,13,19,16,18,25,17,43,32,34,42,1
12.11.2025,2025,ukr,150,BK Zaporozhye,x,68,64,18,10,17,23,16,16,17,15,28,40,32,32,-1
11.11.2025,2025,ukr,148,BC Dnipro,x,74,77,13,16,22,15,19,26,20,20,29,37,45,40,1
11.11.2025,2025,ukr,139,BK Zaporozhye,x,73,75,26,17,21,15,11,23,15,20,43,36,34,35,-1
06.11.2025,2025,ukr,145,Stariy Lutsk,x,76,64,27,19,16,12,15,13,18,20,46,28,28,38,-1
06.11.2025,2025,ukr,142,Rivne,x,66,70,13,20,18,14,15,17,20,19,33,32,32,39,-1
05.11.2025,2025,ukr,146,Rivne,x,85,48,20,16,18,7,26,7,21,18,36,25,33,39,-1
05.11.2025,2025,ukr,141,Stariy Lutsk,x,65,66,20,17,18,13,11,22,16,14,37,31,33,30,-1
01.11.2025,2025,ukr,147,Goverla,x,82,63,24,16,17,20,20,14,21,13,40,37,34,34,-1
01.11.2025,2025,ukr,145,Cherkaski Mavpy,x,84,81,18,19,19,21,15,30,32,11,37,40,45,43,1
31.10.2025,2025,ukr,146,Kryvbas,x,72,64,20,22,22,19,15,13,15,10,42,41,28,25,-1
31.10.2025,2025,ukr,146,Kyiv Basket,x,74,77,20,23,13,19,16,18,25,17,43,32,34,42,1
10.11.2025,2025,vtb,156,Uralmash Ekaterinburg,Samara,81,69,18,13,20,15,29,21,14,20,31,35,50,34,1
10.11.2025,2025,vtb,157,Saratov,Zenit Petersburg,84,88,20,34,25,16,16,21,23,17,54,41,37,40,-1
10.11.2025,2025,vtb,157,Astana,Lokomotiv Kuban,59,93,15,13,13,32,19,20,12,28,28,45,39,40,1
10.11.2025,2025,vtb,147,Enisey,MBA Moscow,78,76,21,21,23,16,15,21,19,18,42,39,36,37,-1
09.11.2025,2025,vtb,151,Parma Perm,Nizhny Novgorod,74,96,11,23,34,29,14,28,15,16,34,63,42,31,-1
09.11.2025,2025,vtb,160,Unics Kazan,CSKA Moscow,73,80,17,20,19,24,21,16,16,20,37,43,37,36,-1
07.11.2025,2025,vtb,153,Zenit Petersburg,Enisey,94,76,25,20,29,16,23,20,17,20,45,45,43,37,1
07.11.2025,2025,vtb,154,Samara,Saratov,73,76,19,15,15,15,21,19,18,27,34,30,40,45,1
06.11.2025,2025,vtb,161,Lokomotiv Kuban,Parma Perm,79,81,19,18,28,24,15,15,17,24,37,52,30,41,-1
06.11.2025,2025,vtb,156,MBA Moscow,CSKA Moscow,67,83,18,18,15,22,14,21,20,22,36,37,35,42,-1
05.11.2025,2025,vtb,152,Nizhny Novgorod,Unics Kazan,73,81,18,31,20,17,20,17,15,16,49,37,37,31,-1
04.11.2025,2025,vtb,158,Uralmash Ekaterinburg,Astana,72,62,16,14,21,15,20,23,15,10,30,36,43,25,-1
10.11.2025,2025,vtb,156,Samara,x,81,69,18,13,20,15,29,21,14,20,31,35,50,34,1
10.11.2025,2025,vtb,157,Zenit Petersburg,x,84,88,20,34,25,16,16,21,23,17,54,41,37,40,-1
10.11.2025,2025,vtb,157,Lokomotiv Kuban,x,59,93,15,13,13,32,19,20,12,28,28,45,39,40,1
10.11.2025,2025,vtb,147,MBA Moscow,x,78,76,21,21,23,16,15,21,19,18,42,39,36,37,-1
09.11.2025,2025,vtb,151,Nizhny Novgorod,x,74,96,11,23,34,29,14,28,15,16,34,63,42,31,-1
09.11.2025,2025,vtb,160,CSKA Moscow,x,73,80,17,20,19,24,21,16,16,20,37,43,37,36,-1
07.11.2025,2025,vtb,153,Enisey,x,94,76,25,20,29,16,23,20,17,20,45,45,43,37,1
07.11.2025,2025,vtb,154,Saratov,x,73,76,19,15,15,15,21,19,18,27,34,30,40,45,1
06.11.2025,2025,vtb,161,Parma Perm,x,79,81,19,18,28,24,15,15,17,24,37,52,30,41,-1
06.11.2025,2025,vtb,156,CSKA Moscow,x,67,83,18,18,15,22,14,21,20,22,36,37,35,42,-1
05.11.2025,2025,vtb,152,Unics Kazan,x,73,81,18,31,20,17,20,17,15,16,49,37,37,31,-1
04.11.2025,2025,vtb,158,Astana,x,72,62,16,14,21,15,20,23,15,10,30,36,43,25,-1
12.11.2025,2025,eurocup,174,Valencia,Cedevita Olimpija,109,80,21,18,36,32,31,10,21,20,39,68,41,41,-1
12.11.2025,2025,eurocup,161,Hamburg,Aris,93,69,24,14,30,24,18,21,21,10,38,54,39,31,-1
12.11.2025,2025,eurocup,171,Trefl Sopot,Hapoel Tel-Aviv,64,93,16,22,16,23,18,22,14,26,38,39,40,40,-1
12.11.2025,2025,eurocup,166,BC Wolves,Trento,88,83,25,21,19,30,22,13,22,19,46,49,35,41,-1
06.11.2025,2025,eurocup,165,Gran Canaria,BC Wolves,66,68,11,10,19,22,14,16,22,20,21,41,30,42,-1
06.11.2025,2025,eurocup,167,Buducnost,Ulm,105,100,25,22,19,20,26,20,18,26,47,39,46,44,1
06.11.2025,2025,eurocup,164,Aris,Valencia,59,63,19,19,14,16,11,17,15,11,38,30,28,26,-1
06.11.2025,2025,eurocup,157,Hapoel Jerusalem,Venezia,94,66,24,20,23,9,22,22,25,15,44,32,44,40,1
06.11.2025,2025,eurocup,165,Cedevita Olimpija,JL Bourg,83,90,17,17,22,21,29,31,15,21,34,43,60,36,1
06.11.2025,2025,eurocup,166,Lietkabelis,Hamburg,91,68,24,21,24,9,22,17,21,21,45,33,39,42,-1
06.11.2025,2025,eurocup,163,Turk Telekom,Cluj-Napoca,99,80,22,30,30,17,28,17,19,16,52,47,45,35,-1
05.11.2025,2025,eurocup,162,Bahcesehir Kol.,Hapoel Tel-Aviv,90,82,22,20,16,24,30,20,22,18,42,40,50,40,1
05.11.2025,2025,eurocup,158,Trento,Joventut Badalona,87,85,17,30,26,16,17,20,27,19,47,42,37,46,1
05.11.2025,2025,eurocup,165,Trefl Sopot,Besiktas,79,100,25,32,26,25,23,24,5,19,57,51,47,24,-1
12.11.2025,2025,eurocup,174,Cedevita Olimpija,x,109,80,21,18,36,32,31,10,21,20,39,68,41,41,-1
12.11.2025,2025,eurocup,161,Aris,x,93,69,24,14,30,24,18,21,21,10,38,54,39,31,-1
12.11.2025,2025,eurocup,171,Hapoel Tel-Aviv,x,64,93,16,22,16,23,18,22,14,26,38,39,40,40,-1
12.11.2025,2025,eurocup,166,Trento,x,88,83,25,21,19,30,22,13,22,19,46,49,35,41,-1
06.11.2025,2025,eurocup,165,BC Wolves,x,66,68,11,10,19,22,14,16,22,20,21,41,30,42,-1
06.11.2025,2025,eurocup,167,Ulm,x,105,100,25,22,19,20,26,20,18,26,47,39,46,44,1
06.11.2025,2025,eurocup,164,Valencia,x,59,63,19,19,14,16,11,17,15,11,38,30,28,26,-1
06.11.2025,2025,eurocup,157,Venezia,x,94,66,24,20,23,9,22,22,25,15,44,32,44,40,1
06.11.2025,2025,eurocup,165,JL Bourg,x,83,90,17,17,22,21,29,31,15,21,34,43,60,36,1
06.11.2025,2025,eurocup,166,Hamburg,x,91,68,24,21,24,9,22,17,21,21,45,33,39,42,-1
06.11.2025,2025,eurocup,163,Cluj-Napoca,x,99,80,22,30,30,17,28,17,19,16,52,47,45,35,-1
05.11.2025,2025,eurocup,162,Hapoel Tel-Aviv,x,90,82,22,20,16,24,30,20,22,18,42,40,50,40,1
05.11.2025,2025,eurocup,158,Joventut Badalona,x,87,85,17,30,26,16,17,20,27,19,47,42,37,46,1
05.11.2025,2025,eurocup,165,Besiktas,x,79,100,25,32,26,25,23,24,5,19,57,51,47,24,-1
12.11.2025,2025,champions,164,Chemnitz,Manresa,78,89,22,9,17,31,28,29,11,20,31,48,57,31,1
12.11.2025,2025,champions,156,Reggiana,Slask Wroclaw,74,70,17,20,24,17,18,12,15,21,37,41,30,36,-1
12.11.2025,2025,champions,158,Karsiyaka,Kolossos Rhodes,95,79,28,25,30,13,18,17,19,24,53,43,35,43,-1
06.11.2025,2025,champions,160,FMP Beograd,Murcia,78,83,22,21,21,12,17,24,18,26,43,33,41,44,1
06.11.2025,2025,champions,157,Igokea,Hapoel Holon,79,86,27,26,15,13,15,24,22,23,53,28,39,45,1
06.11.2025,2025,champions,158,Peristeri,Manisa,90,78,28,15,17,24,22,14,23,25,43,41,36,48,1
06.11.2025,2025,champions,165,Wurzburg,Nanterre,88,96,20,26,19,32,24,19,25,19,46,51,43,44,1
06.11.2025,2025,champions,164,Petkim Spor,Unicaja,56,108,18,27,4,21,19,34,15,26,45,25,53,41,1
05.11.2025,2025,champions,157,Oostende,Szczecin,67,55,17,13,22,13,12,17,16,12,30,35,29,28,-1
05.11.2025,2025,champions,167,Vechta,Nymburk,70,95,20,32,17,21,19,19,14,23,52,38,38,37,-1
05.11.2025,2025,champions,164,Galatasaray,Promitheas,91,74,23,20,24,21,16,13,28,20,43,45,29,48,-1
12.11.2025,2025,champions,164,Manresa,x,78,89,22,9,17,31,28,29,11,20,31,48,57,31,1
12.11.2025,2025,champions,156,Slask Wroclaw,x,74,70,17,20,24,17,18,12,15,21,37,41,30,36,-1
12.11.2025,2025,champions,158,Kolossos Rhodes,x,95,79,28,25,30,13,18,17,19,24,53,43,35,43,-1
06.11.2025,2025,champions,160,Murcia,x,78,83,22,21,21,12,17,24,18,26,43,33,41,44,1
06.11.2025,2025,champions,157,Hapoel Holon,x,79,86,27,26,15,13,15,24,22,23,53,28,39,45,1
06.11.2025,2025,champions,158,Manisa,x,90,78,28,15,17,24,22,14,23,25,43,41,36,48,1
06.11.2025,2025,champions,165,Nanterre,x,88,96,20,26,19,32,24,19,25,19,46,51,43,44,1
06.11.2025,2025,champions,164,Unicaja,x,56,108,18,27,4,21,19,34,15,26,45,25,53,41,1
05.11.2025,2025,champions,157,Szczecin,x,67,55,17,13,22,13,12,17,16,12,30,35,29,28,-1
05.11.2025,2025,champions,167,Nymburk,x,70,95,20,32,17,21,19,19,14,23,52,38,38,37,-1
05.11.2025,2025,champions,164,Promitheas,x,91,74,23,20,24,21,16,13,28,20,43,45,29,48,-1
12.11.2025,2025,fiba,154,Limburg,FC Porto,76,83,16,15,25,16,20,24,15,28,31,41,44,43,1
12.11.2025,2025,fiba,157,Le Portel,Rilski Sportist,74,60,22,11,17,20,18,14,17,15,33,37,32,32,-1
06.11.2025,2025,fiba,155,FC Porto,PAOK,99,64,22,6,20,17,30,12,27,29,28,37,42,56,1
06.11.2025,2025,fiba,161,Cholet,Antwerp Giants,90,77,22,20,19,25,28,13,21,19,42,44,41,40,1
06.11.2025,2025,fiba,158,Spirou Charleroi,Norrkoping,93,86,27,21,19,20,22,23,25,22,48,39,45,47,1
06.11.2025,2025,fiba,168,Basket Zaragoza,Levice,92,71,26,14,16,25,26,10,24,22,40,41,36,46,-1
06.11.2025,2025,fiba,163,Basketball Braunschweig,Keravnos,78,71,21,17,12,18,23,17,22,19,38,30,40,41,-1
06.11.2025,2025,fiba,158,Bilbao,Kutaisi,91,63,16,18,22,10,25,14,28,21,34,32,39,49,1
06.11.2025,2025,fiba,162,Dijon,Caledonia Gladiators,102,62,29,19,17,13,29,16,27,14,48,30,45,41,1
06.11.2025,2025,fiba,165,CSM Constanta,Fribourg Olympic,77,104,20,26,18,19,20,29,19,30,46,37,49,49,1
06.11.2025,2025,fiba,160,Maroussi,Sabah Baku,82,71,12,15,19,22,31,16,20,18,27,41,47,38,1
06.11.2025,2025,fiba,167,Anorthosis,Bursaspor,66,81,18,29,21,13,10,20,17,19,47,34,30,36,-1
06.11.2025,2025,fiba,156,BC Kalev/Cramo,Rilski Sportist,88,76,26,23,19,18,23,17,20,18,49,37,40,38,-1
06.11.2025,2025,fiba,157,Anwil Wloclawek,Sassari,83,86,19,15,15,23,26,20,23,28,34,38,46,51,1
06.11.2025,2025,fiba,145,Arges Pitesti,Spojnia Stargard,77,63,23,20,20,19,19,11,15,13,43,39,30,28,-1
06.11.2025,2025,fiba,157,BC Prievidza,Balkan,83,59,14,15,12,13,30,12,27,19,29,25,42,46,1
06.11.2025,2025,fiba,152,CSM Oradea,Parnu,85,67,18,12,25,17,23,20,19,18,30,42,43,37,1
06.11.2025,2025,fiba,168,Tofas,AEK Larnaca,93,61,28,13,18,26,23,12,24,10,41,44,35,34,-1
05.11.2025,2025,fiba,155,Limburg,Szolnoki Olaj,77,74,14,22,24,17,20,17,19,18,36,41,37,37,-1
05.11.2025,2025,fiba,153,Ludwigsburg,Trepca,87,54,15,11,25,13,25,16,22,14,26,38,41,36,1
05.11.2025,2025,fiba,169,Alba Fehervar,Le Portel,80,104,23,33,8,22,26,23,23,26,56,30,49,49,1
12.11.2025,2025,fiba,154,FC Porto,x,76,83,16,15,25,16,20,24,15,28,31,41,44,43,1
12.11.2025,2025,fiba,157,Rilski Sportist,x,74,60,22,11,17,20,18,14,17,15,33,37,32,32,-1
06.11.2025,2025,fiba,155,PAOK,x,99,64,22,6,20,17,30,12,27,29,28,37,42,56,1
06.11.2025,2025,fiba,161,Antwerp Giants,x,90,77,22,20,19,25,28,13,21,19,42,44,41,40,1
06.11.2025,2025,fiba,158,Norrkoping,x,93,86,27,21,19,20,22,23,25,22,48,39,45,47,1
06.11.2025,2025,fiba,168,Levice,x,92,71,26,14,16,25,26,10,24,22,40,41,36,46,-1
06.11.2025,2025,fiba,163,Keravnos,x,78,71,21,17,12,18,23,17,22,19,38,30,40,41,-1
06.11.2025,2025,fiba,158,Kutaisi,x,91,63,16,18,22,10,25,14,28,21,34,32,39,49,1
06.11.2025,2025,fiba,162,Caledonia Gladiators,x,102,62,29,19,17,13,29,16,27,14,48,30,45,41,1
06.11.2025,2025,fiba,165,Fribourg Olympic,x,77,104,20,26,18,19,20,29,19,30,46,37,49,49,1
06.11.2025,2025,fiba,160,Sabah Baku,x,82,71,12,15,19,22,31,16,20,18,27,41,47,38,1
06.11.2025,2025,fiba,167,Bursaspor,x,66,81,18,29,21,13,10,20,17,19,47,34,30,36,-1
06.11.2025,2025,fiba,156,Rilski Sportist,x,88,76,26,23,19,18,23,17,20,18,49,37,40,38,-1
06.11.2025,2025,fiba,157,Sassari,x,83,86,19,15,15,23,26,20,23,28,34,38,46,51,1
06.11.2025,2025,fiba,145,Spojnia Stargard,x,77,63,23,20,20,19,19,11,15,13,43,39,30,28,-1
06.11.2025,2025,fiba,157,Balkan,x,83,59,14,15,12,13,30,12,27,19,29,25,42,46,1
06.11.2025,2025,fiba,152,Parnu,x,85,67,18,12,25,17,23,20,19,18,30,42,43,37,1
06.11.2025,2025,fiba,168,AEK Larnaca,x,93,61,28,13,18,26,23,12,24,10,41,44,35,34,-1
05.11.2025,2025,fiba,155,Szolnoki Olaj,x,77,74,14,22,24,17,20,17,19,18,36,41,37,37,-1
05.11.2025,2025,fiba,153,Trepca,x,87,54,15,11,25,13,25,16,22,14,26,38,41,36,1
05.11.2025,2025,fiba,169,Le Portel,x,80,104,23,33,8,22,26,23,23,26,56,30,49,49,1
12.11.2025,2025,eurolig,165,Real Madrid,Virtus Bologna,98,86,28,25,25,24,27,18,18,19,53,49,45,37,-1
12.11.2025,2025,eurolig,165,Baskonia,Anadolu Efes,84,89,21,24,18,22,24,19,21,24,45,40,43,45,1
12.11.2025,2025,eurolig,166,Panathinaikos,Maccabi Tel Aviv,93,87,21,25,16,22,23,16,33,24,46,38,39,57,1
12.11.2025,2025,eurolig,162,Alba Berlin,Olimpia Milano,105,101,19,23,24,32,26,22,23,15,42,56,48,38,1
12.11.2025,2025,eurolig,160,Olympiacos,Lyon-Villeurbanne,94,92,24,29,18,21,29,23,23,19,53,39,52,42,1
12.11.2025,2025,eurolig,157,Monaco,Crvena zvezda,90,98,26,26,28,22,20,26,16,24,52,50,46,40,1
12.11.2025,2025,eurolig,162,Fenerbahce,Bayern,87,76,13,21,22,9,32,28,20,18,34,31,60,38,1
08.11.2025,2025,eurolig,166,Barcelona,Baskonia,91,68,26,17,18,16,18,18,29,17,43,34,36,46,-1
08.11.2025,2025,eurolig,164,Virtus Bologna,Maccabi Tel Aviv,84,77,25,17,20,22,15,16,24,22,42,42,31,46,-1
08.11.2025,2025,eurolig,157,Panathinaikos,Olympiacos,89,94,15,20,18,21,33,30,23,23,35,39,63,46,1
08.11.2025,2025,eurolig,158,Lyon-Villeurbanne,Fenerbahce,73,77,19,15,17,18,16,18,21,26,34,35,34,47,1
08.11.2025,2025,eurolig,164,Anadolu Efes,Monaco,69,81,23,22,18,14,18,16,10,29,45,32,34,39,-1
07.11.2025,2025,eurolig,160,Bayern,Zalgiris Kaunas,77,74,19,7,19,21,20,19,19,27,26,40,39,46,1
07.11.2025,2025,eurolig,169,Paris,Partizan,74,71,21,16,16,19,19,22,18,14,37,35,41,32,-1
07.11.2025,2025,eurolig,163,Olimpia Milano,Real Madrid,85,76,24,16,23,24,15,15,23,21,40,47,30,44,-1
07.11.2025,2025,eurolig,160,Crvena zvezda,Alba Berlin,92,71,23,14,18,18,22,18,29,21,37,36,40,50,1
12.11.2025,2025,eurolig,165,Virtus Bologna,x,98,86,28,25,25,24,27,18,18,19,53,49,45,37,-1
12.11.2025,2025,eurolig,165,Anadolu Efes,x,84,89,21,24,18,22,24,19,21,24,45,40,43,45,1
12.11.2025,2025,eurolig,166,Maccabi Tel Aviv,x,93,87,21,25,16,22,23,16,33,24,46,38,39,57,1
12.11.2025,2025,eurolig,162,Olimpia Milano,x,105,101,19,23,24,32,26,22,23,15,42,56,48,38,1
12.11.2025,2025,eurolig,160,Lyon-Villeurbanne,x,94,92,24,29,18,21,29,23,23,19,53,39,52,42,1
12.11.2025,2025,eurolig,157,Crvena zvezda,x,90,98,26,26,28,22,20,26,16,24,52,50,46,40,1
12.11.2025,2025,eurolig,162,Bayern,x,87,76,13,21,22,9,32,28,20,18,34,31,60,38,1
08.11.2025,2025,eurolig,166,Baskonia,x,91,68,26,17,18,16,18,18,29,17,43,34,36,46,-1
08.11.2025,2025,eurolig,164,Maccabi Tel Aviv,x,84,77,25,17,20,22,15,16,24,22,42,42,31,46,-1
08.11.2025,2025,eurolig,157,Olympiacos,x,89,94,15,20,18,21,33,30,23,23,35,39,63,46,1
08.11.2025,2025,eurolig,158,Fenerbahce,x,73,77,19,15,17,18,16,18,21,26,34,35,34,47,1
08.11.2025,2025,eurolig,164,Monaco,x,69,81,23,22,18,14,18,16,10,29,45,32,34,39,-1
07.11.2025,2025,eurolig,160,Zalgiris Kaunas,x,77,74,19,7,19,21,20,19,19,27,26,40,39,46,1
07.11.2025,2025,eurolig,169,Partizan,x,74,71,21,16,16,19,19,22,18,14,37,35,41,32,-1
07.11.2025,2025,eurolig,163,Real Madrid,x,85,76,24,16,23,24,15,15,23,21,40,47,30,44,-1
07.11.2025,2025,eurolig,160,Alba Berlin,x,92,71,23,14,18,18,22,18,29,21,37,36,40,50,1
11.11.2025,2025,kore w,132,Busan BNK Sum W,Hana 1Q W,65,45,18,19,11,14,19,6,17,6,37,25,25,23,-1
10.11.2025,2025,kore w,128,Samsung Blue Minx W,KB Stars W,64,53,22,11,12,16,12,7,18,19,33,28,19,37,-1
09.11.2025,2025,kore w,132,S-Birds W,Busan BNK Sum W,57,77,14,16,10,20,15,15,18,26,30,30,30,44,1
08.11.2025,2025,kore w,129,Hana 1Q W,Woori WON W,62,65,22,23,14,7,13,16,13,19,45,21,29,32,-1
07.11.2025,2025,kore w,131,S-Birds W,Samsung Blue Minx W,66,58,17,9,18,17,10,12,21,20,26,35,22,41,-1
06.11.2025,2025,kore w,131,Busan BNK Sum W,KB Stars W,66,56,17,12,19,14,12,18,18,12,29,33,30,30,-1
04.11.2025,2025,kore w,129,Woori WON W,Samsung Blue Minx W,73,65,20,25,17,17,21,12,15,11,45,34,33,26,-1
03.11.2025,2025,kore w,130,Hana 1Q W,S-Birds W,70,56,19,9,23,15,17,19,11,13,28,38,36,24,-1
02.11.2025,2025,kore w,134,Woori WON W,Busan BNK Sum W,54,70,18,26,10,15,15,16,11,13,44,25,31,24,-1
01.11.2025,2025,kore w,129,Samsung Blue Minx W,Hana 1Q W,57,75,19,17,18,32,17,13,3,13,36,50,30,16,-1
31.10.2025,2025,kore w,132,KB Stars W,S-Birds W,67,59,20,11,17,17,17,16,13,15,31,34,33,28,-1
30.10.2025,2025,kore w,138,Busan BNK Sum W,Samsung Blue Minx W,69,64,15,15,22,15,21,19,11,15,30,37,40,26,-1
28.10.2025,2025,kore w,129,S-Birds W,Woori WON W,64,76,22,28,14,9,15,20,13,19,50,23,35,32,1
27.10.2025,2025,kore w,134,Hana 1Q W,KB Stars W,56,64,16,17,11,16,15,23,14,8,33,27,38,22,-1
11.11.2025,2025,kore w,132,Hana 1Q W,x,65,45,18,19,11,14,19,6,17,6,37,25,25,23,-1
10.11.2025,2025,kore w,128,KB Stars W,x,64,53,22,11,12,16,12,7,18,19,33,28,19,37,-1
09.11.2025,2025,kore w,132,Busan BNK Sum W,x,57,77,14,16,10,20,15,15,18,26,30,30,30,44,1
08.11.2025,2025,kore w,129,Woori WON W,x,62,65,22,23,14,7,13,16,13,19,45,21,29,32,-1
07.11.2025,2025,kore w,131,Samsung Blue Minx W,x,66,58,17,9,18,17,10,12,21,20,26,35,22,41,-1
06.11.2025,2025,kore w,131,KB Stars W,x,66,56,17,12,19,14,12,18,18,12,29,33,30,30,-1
04.11.2025,2025,kore w,129,Samsung Blue Minx W,x,73,65,20,25,17,17,21,12,15,11,45,34,33,26,-1
03.11.2025,2025,kore w,130,S-Birds W,x,70,56,19,9,23,15,17,19,11,13,28,38,36,24,-1
02.11.2025,2025,kore w,134,Busan BNK Sum W,x,54,70,18,26,10,15,15,16,11,13,44,25,31,24,-1
01.11.2025,2025,kore w,129,Hana 1Q W,x,57,75,19,17,18,32,17,13,3,13,36,50,30,16,-1
31.10.2025,2025,kore w,132,S-Birds W,x,67,59,20,11,17,17,17,16,13,15,31,34,33,28,-1
30.10.2025,2025,kore w,138,Samsung Blue Minx W,x,69,64,15,15,22,15,21,19,11,15,30,37,40,26,-1
28.10.2025,2025,kore w,129,Woori WON W,x,64,76,22,28,14,9,15,20,13,19,50,23,35,32,1
27.10.2025,2025,kore w,134,KB Stars W,x,56,64,16,17,11,16,15,23,14,8,33,27,38,22,-1
15.11.2025,2025,eng,166,London Lions,Caledonia Gladiators,98,76,27,15,22,20,24,25,25,16,42,42,49,41,1
15.11.2025,2025,eng,165,Newcastle Eagles,Surrey 89ers,81,77,18,20,20,26,20,16,23,15,38,46,36,38,-1
10.11.2025,2025,eng,169,Cheshire Phoenix,Sheffield Sharks,87,86,16,27,24,23,23,17,24,19,43,47,40,43,-1
10.11.2025,2025,eng,167,London Lions,Newcastle Eagles,89,79,20,16,26,17,17,24,26,22,36,43,41,48,1
09.11.2025,2025,eng,162,Surrey 89ers,Caledonia Gladiators,92,83,27,24,17,19,26,21,22,19,51,36,47,41,1
08.11.2025,2025,eng,175,Bristol Flyers,Cheshire Phoenix,84,88,18,24,22,30,17,23,27,11,42,52,40,38,-1
08.11.2025,2025,eng,159,Leicester Riders,Sheffield Sharks,79,82,22,21,24,28,19,12,14,21,43,52,31,35,-1
03.11.2025,2025,eng,167,Caledonia Gladiators,Newcastle Eagles,71,94,19,28,12,21,19,19,21,26,47,33,38,47,1
03.11.2025,2025,eng,159,Sheffield Sharks,Bristol Flyers,102,90,21,27,31,16,28,17,22,30,48,47,45,52,1
03.11.2025,2025,eng,167,Manchester Basketball,London Lions,93,99,24,21,19,26,23,17,24,26,45,45,40,50,1
02.11.2025,2025,eng,163,Surrey 89ers,Leicester Riders,66,82,21,20,10,16,12,23,23,23,41,26,35,46,-1
01.11.2025,2025,eng,160,London Lions,Sheffield Sharks,92,68,18,23,28,14,21,16,25,15,41,42,37,40,-1
15.11.2025,2025,eng,166,Caledonia Gladiators,x,98,76,27,15,22,20,24,25,25,16,42,42,49,41,1
15.11.2025,2025,eng,165,Surrey 89ers,x,81,77,18,20,20,26,20,16,23,15,38,46,36,38,-1
10.11.2025,2025,eng,169,Sheffield Sharks,x,87,86,16,27,24,23,23,17,24,19,43,47,40,43,-1
10.11.2025,2025,eng,167,Newcastle Eagles,x,89,79,20,16,26,17,17,24,26,22,36,43,41,48,1
09.11.2025,2025,eng,162,Caledonia Gladiators,x,92,83,27,24,17,19,26,21,22,19,51,36,47,41,1
08.11.2025,2025,eng,175,Cheshire Phoenix,x,84,88,18,24,22,30,17,23,27,11,42,52,40,38,-1
08.11.2025,2025,eng,159,Sheffield Sharks,x,79,82,22,21,24,28,19,12,14,21,43,52,31,35,-1
03.11.2025,2025,eng,167,Newcastle Eagles,x,71,94,19,28,12,21,19,19,21,26,47,33,38,47,1
03.11.2025,2025,eng,159,Bristol Flyers,x,102,90,21,27,31,16,28,17,22,30,48,47,45,52,1
03.11.2025,2025,eng,167,London Lions,x,93,99,24,21,19,26,23,17,24,26,45,45,40,50,1
02.11.2025,2025,eng,163,Leicester Riders,x,66,82,21,20,10,16,12,23,23,23,41,26,35,46,-1
01.11.2025,2025,eng,160,Sheffield Sharks,x,92,68,18,23,28,14,21,16,25,15,41,42,37,40,-1
16.11.2025,2025,kore w,132,Busan BNK Sum W,S-Birds W,46,38,15,12,10,10,13,11,8,5,27,20,24,13,-1
15.11.2025,2025,kore w,126,KB Stars W,Hana 1Q W,78,58,13,9,25,17,19,13,21,19,22,42,32,40,1
14.11.2025,2025,kore w,128,Samsung Blue Minx W,S-Birds W,74,69,16,18,19,17,23,25,16,9,34,36,48,25,1
13.11.2025,2025,kore w,127,KB Stars W,Woori WON W,58,54,13,23,19,14,16,9,10,8,36,33,25,18,-1
16.11.2025,2025,kore w,132,S-Birds W,x,46,38,15,12,10,10,13,11,8,5,27,20,24,13,-1
15.11.2025,2025,kore w,126,Hana 1Q W,x,78,58,13,9,25,17,19,13,21,19,22,42,32,40,1
14.11.2025,2025,kore w,128,S-Birds W,x,74,69,16,18,19,17,23,25,16,9,34,36,48,25,1
13.11.2025,2025,kore w,127,Woori WON W,x,58,54,13,23,19,14,16,9,10,8,36,33,25,18,-1
10.11.2025,2025,aba,163,Partizan,Dubai,82,61,16,19,19,8,19,17,28,17,35,27,36,45,-1
10.11.2025,2025,aba,162,Subotica,Igokea,86,75,23,19,19,17,17,27,27,12,42,36,44,39,1
10.11.2025,2025,aba,157,Borac,Buducnost,82,88,20,25,16,29,25,14,21,20,45,45,39,41,1
10.11.2025,2025,aba,163,Mega Basket,Crvena zvezda,76,81,23,16,21,22,19,24,13,19,39,43,43,32,-1
10.11.2025,2025,aba,163,Partizan,Dubai,82,61,16,19,19,8,19,17,28,17,35,27,36,45,-1
10.11.2025,2025,aba,162,Subotica,Igokea,86,75,23,19,19,17,17,27,27,12,42,36,44,39,1
10.11.2025,2025,aba,157,Borac,Buducnost,82,88,20,25,16,29,25,14,21,20,45,45,39,41,1
10.11.2025,2025,aba,163,Mega Basket,Crvena zvezda,76,81,23,16,21,22,19,24,13,19,39,43,43,32,-1
10.11.2025,2025,aba,163,Dubai,x,82,61,16,19,19,8,19,17,28,17,35,27,36,45,-1
10.11.2025,2025,aba,162,Igokea,x,86,75,23,19,19,17,17,27,27,12,42,36,44,39,1
10.11.2025,2025,aba,157,Buducnost,x,82,88,20,25,16,29,25,14,21,20,45,45,39,41,1
10.11.2025,2025,aba,163,Crvena zvezda,x,76,81,23,16,21,22,19,24,13,19,39,43,43,32,-1
10.11.2025,2025,aba,163,Dubai,x,82,61,16,19,19,8,19,17,28,17,35,27,36,45,-1
10.11.2025,2025,aba,162,Igokea,x,86,75,23,19,19,17,17,27,27,12,42,36,44,39,1
10.11.2025,2025,aba,157,Buducnost,x,82,88,20,25,16,29,25,14,21,20,45,45,39,41,1
10.11.2025,2025,aba,163,Crvena zvezda,x,76,81,23,16,21,22,19,24,13,19,39,43,43,32,-1
16.11.2025,2025,aba,163,Cedevita Olimpija,Mega Basket,93,82,24,21,22,25,18,20,29,16,45,47,38,45,1
15.11.2025,2025,aba,160,Split,Studentski Centar,88,85,16,19,17,15,25,29,19,14,35,32,54,33,1
15.11.2025,2025,aba,159,Igokea,Cibona,95,84,17,24,24,18,29,16,25,26,41,42,45,51,1
11.11.2025,2025,aba,164,Studentski Centar,Mornar Bar,99,91,23,17,25,15,27,30,24,29,40,40,57,53,1
11.11.2025,2025,aba,160,KK Krka Novo mesto,FMP Beograd,106,109,21,28,20,24,19,13,26,21,49,44,32,47,-1
16.11.2025,2025,aba,163,Mega Basket,x,93,82,24,21,22,25,18,20,29,16,45,47,38,45,1
15.11.2025,2025,aba,160,Studentski Centar,x,88,85,16,19,17,15,25,29,19,14,35,32,54,33,1
15.11.2025,2025,aba,159,Cibona,x,95,84,17,24,24,18,29,16,25,26,41,42,45,51,1
11.11.2025,2025,aba,164,Mornar Bar,x,99,91,23,17,25,15,27,30,24,29,40,40,57,53,1
11.11.2025,2025,aba,160,FMP Beograd,x,106,109,21,28,20,24,19,13,26,21,49,44,32,47,-1
,2025,arj,164,Independiente de Oliva,Ferro,87,92,26,12,16,42,18,19,27,19,38,58,37,46,1
,2025,arj,168,Quimsa,La Union,94,64,30,18,22,17,18,11,24,18,48,39,29,42,-1
,2025,arj,158,Obera TC,Atenas,98,76,35,20,16,19,24,14,23,23,55,35,38,46,1
,2025,arj,157,Argentino,Platense,54,75,16,24,19,19,9,22,10,10,40,38,31,20,-1
,2025,arj,159,Instituto de Cordoba,Ferro,79,67,21,16,17,13,25,20,16,18,37,30,45,34,-1
,2025,arj,164,Riachuelo,La Union,90,86,21,16,27,27,25,20,17,23,37,54,45,40,1
,2025,arj,158,Gimnasia,Boca Juniors,67,83,22,24,14,21,10,19,21,19,46,35,29,40,-1
,2025,arj,164,Union De Santa Fe,Independiente de Oliva,89,87,19,15,26,27,21,19,23,26,34,53,40,49,1
,2025,arj,164,Olimpico,Quimsa,78,65,23,19,15,15,19,13,21,18,42,30,32,39,-1
,2025,arj,155,Atenas,Ferro,97,74,34,18,27,15,17,28,19,13,52,42,45,32,-1
,2025,arj,158,Zarate,Platense,76,72,21,33,16,13,16,15,23,11,54,29,31,34,-1
,2025,arj,163,Penarol,Obras Sanitarias,82,71,22,19,16,16,19,26,25,10,41,32,45,35,-1
,2025,arj,167,Obera TC,Independiente de Oliva,83,81,27,21,16,28,17,20,23,12,48,44,37,35,-1
,2025,arj,153,Instituto de Cordoba,San Lorenzo,94,65,22,17,21,7,20,21,31,20,39,28,41,51,1
,2025,arj,170,La Union,Regatas,78,79,23,22,19,21,22,18,14,18,45,40,40,32,-1
,2025,arj,153,Atenas,San Lorenzo,84,61,22,20,20,10,18,18,24,13,42,30,36,37,-1
,2025,arj,164,Riachuelo,Olimpico,90,66,24,23,27,8,17,14,22,21,47,35,31,43,-1
,2025,arj,163,Boca Juniors,Obras Sanitarias,78,59,27,14,10,6,22,18,19,21,41,16,40,40,-1
,2025,arj,154,Quimsa,Zarate,91,70,30,21,16,22,25,16,20,11,51,38,41,31,-1
,2025,arj,166,Atenas,Olimpico,75,64,18,20,15,15,20,13,22,16,38,30,33,38,-1
,2025,arj,157,Independiente de Oliva,San Lorenzo,88,98,24,21,22,30,20,21,22,26,45,52,41,48,1
,2025,arj,156,Riachuelo,Zarate,79,65,24,18,21,16,18,10,16,21,42,37,28,37,-1
,2025,arj,148,San Martin,La Union,94,96,19,15,19,22,17,21,25,22,34,41,38,47,1
,2025,arj,160,Obera TC,Boca Juniors,81,83,21,15,18,21,21,25,21,22,36,39,46,43,1
,2025,arj,165,Obras Sanitarias,Quimsa,78,64,17,11,25,16,15,19,21,18,28,41,34,39,-1
,2025,arj,161,Olimpico,Zarate,87,77,10,16,25,17,28,23,24,21,26,42,51,45,1
,2025,arj,151,Regatas,San Martin,83,69,22,21,17,14,27,15,17,19,43,31,42,36,1
,2025,arj,161,Gimnasia,Riachuelo,76,65,23,23,16,20,16,8,21,14,46,36,24,35,-1
,2025,arj,156,San Lorenzo,Quimsa,63,73,19,18,20,24,12,13,12,18,37,44,25,30,-1
,2025,arj,161,Regatas,Union De Santa Fe,88,73,25,19,23,20,20,15,20,19,44,43,35,39,-1
,2025,arj,162,Gimnasia,Quimsa,88,84,23,19,18,22,25,24,22,19,42,40,49,41,1
,2025,arj,155,San Lorenzo,Riachuelo,73,77,27,21,12,24,20,22,14,10,48,36,42,24,-1
,2025,arj,164,Olimpico,Argentino,95,69,19,19,21,16,28,15,27,19,38,37,43,46,1
,2025,arj,151,San Martin,Obera TC,74,67,29,14,19,24,9,16,17,13,43,43,25,30,-1
,2025,arj,162,Independiente de Oliva,Instituto de Cordoba,70,87,19,18,18,24,17,23,16,22,37,42,40,38,-1
,2025,arj,164,Ferro,x,87,92,26,12,16,42,18,19,27,19,38,58,37,46,1
,2025,arj,168,La Union,x,94,64,30,18,22,17,18,11,24,18,48,39,29,42,-1
,2025,arj,158,Atenas,x,98,76,35,20,16,19,24,14,23,23,55,35,38,46,1
,2025,arj,157,Platense,x,54,75,16,24,19,19,9,22,10,10,40,38,31,20,-1
,2025,arj,159,Ferro,x,79,67,21,16,17,13,25,20,16,18,37,30,45,34,-1
,2025,arj,164,La Union,x,90,86,21,16,27,27,25,20,17,23,37,54,45,40,1
,2025,arj,158,Boca Juniors,x,67,83,22,24,14,21,10,19,21,19,46,35,29,40,-1
,2025,arj,164,Independiente de Oliva,x,89,87,19,15,26,27,21,19,23,26,34,53,40,49,1
,2025,arj,164,Quimsa,x,78,65,23,19,15,15,19,13,21,18,42,30,32,39,-1
,2025,arj,155,Ferro,x,97,74,34,18,27,15,17,28,19,13,52,42,45,32,-1
,2025,arj,158,Platense,x,76,72,21,33,16,13,16,15,23,11,54,29,31,34,-1
,2025,arj,163,Obras Sanitarias,x,82,71,22,19,16,16,19,26,25,10,41,32,45,35,-1
,2025,arj,167,Independiente de Oliva,x,83,81,27,21,16,28,17,20,23,12,48,44,37,35,-1
,2025,arj,153,San Lorenzo,x,94,65,22,17,21,7,20,21,31,20,39,28,41,51,1
,2025,arj,170,Regatas,x,78,79,23,22,19,21,22,18,14,18,45,40,40,32,-1
,2025,arj,153,San Lorenzo,x,84,61,22,20,20,10,18,18,24,13,42,30,36,37,-1
,2025,arj,164,Olimpico,x,90,66,24,23,27,8,17,14,22,21,47,35,31,43,-1
,2025,arj,163,Obras Sanitarias,x,78,59,27,14,10,6,22,18,19,21,41,16,40,40,-1
,2025,arj,154,Zarate,x,91,70,30,21,16,22,25,16,20,11,51,38,41,31,-1
,2025,arj,166,Olimpico,x,75,64,18,20,15,15,20,13,22,16,38,30,33,38,-1
,2025,arj,157,San Lorenzo,x,88,98,24,21,22,30,20,21,22,26,45,52,41,48,1
,2025,arj,156,Zarate,x,79,65,24,18,21,16,18,10,16,21,42,37,28,37,-1
,2025,arj,148,La Union,x,94,96,19,15,19,22,17,21,25,22,34,41,38,47,1
,2025,arj,160,Boca Juniors,x,81,83,21,15,18,21,21,25,21,22,36,39,46,43,1
,2025,arj,165,Quimsa,x,78,64,17,11,25,16,15,19,21,18,28,41,34,39,-1
,2025,arj,161,Zarate,x,87,77,10,16,25,17,28,23,24,21,26,42,51,45,1
,2025,arj,151,San Martin,x,83,69,22,21,17,14,27,15,17,19,43,31,42,36,1
,2025,arj,161,Riachuelo,x,76,65,23,23,16,20,16,8,21,14,46,36,24,35,-1
,2025,arj,156,Quimsa,x,63,73,19,18,20,24,12,13,12,18,37,44,25,30,-1
,2025,arj,161,Union De Santa Fe,x,88,73,25,19,23,20,20,15,20,19,44,43,35,39,-1
,2025,arj,162,Quimsa,x,88,84,23,19,18,22,25,24,22,19,42,40,49,41,1
,2025,arj,155,Riachuelo,x,73,77,27,21,12,24,20,22,14,10,48,36,42,24,-1
,2025,arj,164,Argentino,x,95,69,19,19,21,16,28,15,27,19,38,37,43,46,1
,2025,arj,151,Obera TC,x,74,67,29,14,19,24,9,16,17,13,43,43,25,30,-1
,2025,arj,162,Instituto de Cordoba,x,70,87,19,18,18,24,17,23,16,22,37,42,40,38,-1
,2025,aba,160,Crvena zvezda,Borac,105,85,24,14,31,26,28,18,22,27,38,57,46,49,1
,2025,aba,163,Buducnost,Spartak Subotica,75,78,13,23,22,17,22,18,18,20,36,39,40,38,-1
,2025,aba,165,Mornar Bar,Partizan,78,105,16,28,14,21,26,29,22,27,44,35,55,49,1
,2025,aba,165,Dubai,KK Krka Novo mesto,91,76,24,23,21,15,25,19,21,19,47,36,44,40,1
,2025,aba,156,FMP Beograd,Zadar,67,83,14,17,21,27,13,15,19,24,31,48,28,43,-1
,2025,aba,160,Borac,x,105,85,24,14,31,26,28,18,22,27,38,57,46,49,1
,2025,aba,163,Spartak Subotica,x,75,78,13,23,22,17,22,18,18,20,36,39,40,38,-1
,2025,aba,165,Partizan,x,78,105,16,28,14,21,26,29,22,27,44,35,55,49,1
,2025,aba,165,KK Krka Novo mesto,x,91,76,24,23,21,15,25,19,21,19,47,36,44,40,1
,2025,aba,156,Zadar,x,67,83,14,17,21,27,13,15,19,24,31,48,28,43,-1
,2025,eng,174,Cheshire Phoenix,London Lions,93,97,28,21,17,25,26,26,22,25,49,42,52,47,1
,2025,eng,167,Caledonia Gladiators,Newcastle Eagles,76,90,15,24,18,16,31,28,12,22,39,34,59,34,1
,2025,eng,164,Sheffield Sharks,Leicester Riders,79,61,15,22,21,10,26,16,17,13,37,31,42,30,-1
,2025,eng,173,Bristol Flyers,Manchester Basketball,92,85,11,19,19,25,28,13,21,22,30,44,41,43,-1
,2025,eng,174,London Lions,x,93,97,28,21,17,25,26,26,22,25,49,42,52,47,1
,2025,eng,167,Newcastle Eagles,x,76,90,15,24,18,16,31,28,12,22,39,34,59,34,1
,2025,eng,164,Leicester Riders,x,79,61,15,22,21,10,26,16,17,13,37,31,42,30,-1
,2025,eng,173,Manchester Basketball,x,92,85,11,19,19,25,28,13,21,22,30,44,41,43,-1
,2025,eurocup,159,Joventut Badalona,Buducnost,78,72,19,20,21,16,21,24,17,12,39,37,45,29,-1
,2025,eurocup,155,Venezia,Turk Telekom,75,67,12,10,18,14,25,22,20,21,22,32,47,41,1
,2025,eurocup,162,Hapoel Jerusalem,JL Bourg,86,77,22,21,15,20,26,14,23,22,43,35,40,45,1
,2025,eurocup,166,Ulm,Bahcesehir Kol.,72,80,16,13,20,28,16,15,20,24,29,48,31,44,-1
,2025,eurocup,160,Besiktas,Gran Canaria,74,76,18,21,15,17,24,15,17,23,39,32,39,40,-1
,2025,eurocup,165,Cluj-Napoca,Lietkabelis,100,93,32,18,24,20,20,13,24,42,50,44,33,66,1
,2025,eurocup,159,Buducnost,x,78,72,19,20,21,16,21,24,17,12,39,37,45,29,-1
,2025,eurocup,155,Turk Telekom,x,75,67,12,10,18,14,25,22,20,21,22,32,47,41,1
,2025,eurocup,162,JL Bourg,x,86,77,22,21,15,20,26,14,23,22,43,35,40,45,1
,2025,eurocup,166,Bahcesehir Kol.,x,72,80,16,13,20,28,16,15,20,24,29,48,31,44,-1
,2025,eurocup,160,Gran Canaria,x,74,76,18,21,15,17,24,15,17,23,39,32,39,40,-1
,2025,eurocup,165,Lietkabelis,x,100,93,32,18,24,20,20,13,24,42,50,44,33,66,1
,2025,fiba,161,Sporting CP,Anwil Wloclawek,83,97,21,21,13,23,24,27,25,26,42,36,51,51,1
,2025,fiba,166,Basketball Braunschweig,Tofas,92,97,21,24,22,29,23,24,26,20,45,51,47,46,1
,2025,fiba,166,Bilbao,BC Prievidza,87,66,21,16,27,22,23,9,16,19,37,49,32,35,-1
,2025,fiba,158,Dijon,Ludwigsburg,81,93,15,23,26,29,25,19,15,22,38,55,44,37,1
,2025,fiba,166,CSM Constanta,Cholet,68,104,16,29,15,27,23,23,14,25,45,42,46,39,1
,2025,fiba,159,Maroussi,Spirou Charleroi,87,70,24,14,23,20,27,22,13,14,38,43,49,27,-1
,2025,fiba,168,Anorthosis,Basket Zaragoza,76,83,20,27,15,21,15,16,26,19,47,36,31,45,-1
,2025,fiba,163,Fribourg Olympic,Antwerp Giants,102,84,26,15,26,15,21,27,29,27,41,41,48,56,1
,2025,fiba,159,Norrkoping,Sabah Baku,75,83,22,21,14,17,19,22,20,23,43,31,41,43,1
,2025,fiba,152,Spojnia Stargard,Parnu,83,59,19,18,23,14,25,12,16,15,37,37,37,31,-1
,2025,fiba,163,Bursaspor,Levice,97,101,28,25,21,18,23,33,25,25,53,39,56,50,1
,2025,fiba,158,Keravnos,AEK Larnaca,91,92,27,28,30,29,19,17,15,18,55,59,36,33,-1
,2025,fiba,171,Alba Fehervar,BC Kalev/Cramo,93,90,18,21,21,24,22,16,21,21,39,45,38,42,-1
,2025,fiba,150,Arges Pitesti,CSM Oradea,80,78,27,15,16,21,16,19,21,23,42,37,35,44,1
,2025,fiba,158,Szolnoki Olaj,PAOK,69,92,15,17,19,22,15,20,20,33,32,41,35,53,1
,2025,fiba,163,Kutaisi,Balkan,93,92,22,28,26,19,20,15,17,23,50,45,35,40,-1
,2025,fiba,161,Anwil Wloclawek,x,83,97,21,21,13,23,24,27,25,26,42,36,51,51,1
,2025,fiba,166,Tofas,x,92,97,21,24,22,29,23,24,26,20,45,51,47,46,1
,2025,fiba,166,BC Prievidza,x,87,66,21,16,27,22,23,9,16,19,37,49,32,35,-1
,2025,fiba,158,Ludwigsburg,x,81,93,15,23,26,29,25,19,15,22,38,55,44,37,1
,2025,fiba,166,Cholet,x,68,104,16,29,15,27,23,23,14,25,45,42,46,39,1
,2025,fiba,159,Spirou Charleroi,x,87,70,24,14,23,20,27,22,13,14,38,43,49,27,-1
,2025,fiba,168,Basket Zaragoza,x,76,83,20,27,15,21,15,16,26,19,47,36,31,45,-1
,2025,fiba,163,Antwerp Giants,x,102,84,26,15,26,15,21,27,29,27,41,41,48,56,1
,2025,fiba,159,Sabah Baku,x,75,83,22,21,14,17,19,22,20,23,43,31,41,43,1
,2025,fiba,152,Parnu,x,83,59,19,18,23,14,25,12,16,15,37,37,37,31,-1
,2025,fiba,163,Levice,x,97,101,28,25,21,18,23,33,25,25,53,39,56,50,1
,2025,fiba,158,AEK Larnaca,x,91,92,27,28,30,29,19,17,15,18,55,59,36,33,-1
,2025,fiba,171,BC Kalev/Cramo,x,93,90,18,21,21,24,22,16,21,21,39,45,38,42,-1
,2025,fiba,150,CSM Oradea,x,80,78,27,15,16,21,16,19,21,23,42,37,35,44,1
,2025,fiba,158,PAOK,x,69,92,15,17,19,22,15,20,20,33,32,41,35,53,1
,2025,fiba,163,Balkan,x,93,92,22,28,26,19,20,15,17,23,50,45,35,40,-1
,2025,fiba,152,Tenerife,Saint Quentin,96,57,22,13,19,18,30,10,25,16,35,37,40,41,1
,2025,fiba,161,Tortona,Benfica,77,71,15,19,20,26,22,16,20,10,34,46,38,30,-1
,2025,fiba,167,Bonn,Maccabi Ironi Ramat Gan,80,76,18,27,23,15,21,16,18,18,45,38,37,36,-1
,2025,fiba,157,AEK Athens,VEF Riga,80,70,19,23,24,13,19,20,18,14,42,37,39,32,-1
,2025,fiba,170,Szombathely,Rytas,72,82,15,21,25,13,17,19,11,15,36,38,36,26,-1
,2025,fiba,152,Saint Quentin,x,96,57,22,13,19,18,30,10,25,16,35,37,40,41,1
,2025,fiba,161,Benfica,x,77,71,15,19,20,26,22,16,20,10,34,46,38,30,-1
,2025,fiba,167,Maccabi Ironi Ramat Gan,x,80,76,18,27,23,15,21,16,18,18,45,38,37,36,-1
,2025,fiba,157,VEF Riga,x,80,70,19,23,24,13,19,20,18,14,42,37,39,32,-1
,2025,fiba,170,Rytas,x,72,82,15,21,25,13,17,19,11,15,36,38,36,26,-1
,2025,eurolig,170,Barcelona,Paris,87,103,18,31,30,14,22,28,17,30,49,44,50,47,1
,2025,eurolig,163,Partizan,Olimpia Milano,81,88,22,19,20,19,23,26,16,24,41,39,49,40,1
,2025,eurolig,164,Virtus Bologna,Panathinaikos,77,82,18,19,25,27,15,14,19,22,37,52,29,41,-1
,2025,eurolig,154,Zalgiris Kaunas,Fenerbahce,65,72,21,17,5,26,21,9,18,20,38,31,30,38,-1
,2025,eurolig,170,Real Madrid,Anadolu Efes,64,74,6,19,19,28,24,11,15,16,25,47,35,31,-1
,2025,eurolig,164,Baskonia,Monaco,75,87,7,24,17,23,31,14,20,26,31,40,45,46,1
,2025,eurolig,161,Bayern,Alba Berlin,115,88,28,27,34,17,34,14,19,30,55,51,48,49,1
,2025,eurolig,162,Lyon-Villeurbanne,Crvena zvezda,77,74,24,20,19,12,15,19,19,23,44,31,34,42,-1
,2025,eurolig,165,Maccabi Tel Aviv,Olympiacos,91,94,24,29,29,13,10,28,28,24,53,42,38,52,1
,2025,eurolig,161,Paris,Zalgiris Kaunas,83,77,17,16,23,20,22,20,21,21,33,43,42,42,1
,2025,eurolig,164,Partizan,Barcelona,79,87,23,19,12,30,23,21,21,17,42,42,44,38,-1
,2025,eurolig,170,Paris,x,87,103,18,31,30,14,22,28,17,30,49,44,50,47,1
,2025,eurolig,163,Olimpia Milano,x,81,88,22,19,20,19,23,26,16,24,41,39,49,40,1
,2025,eurolig,164,Panathinaikos,x,77,82,18,19,25,27,15,14,19,22,37,52,29,41,-1
,2025,eurolig,154,Fenerbahce,x,65,72,21,17,5,26,21,9,18,20,38,31,30,38,-1
,2025,eurolig,170,Anadolu Efes,x,64,74,6,19,19,28,24,11,15,16,25,47,35,31,-1
,2025,eurolig,164,Monaco,x,75,87,7,24,17,23,31,14,20,26,31,40,45,46,1
,2025,eurolig,161,Alba Berlin,x,115,88,28,27,34,17,34,14,19,30,55,51,48,49,1
,2025,eurolig,162,Crvena zvezda,x,77,74,24,20,19,12,15,19,19,23,44,31,34,42,-1
,2025,eurolig,165,Olympiacos,x,91,94,24,29,29,13,10,28,28,24,53,42,38,52,1
,2025,eurolig,161,Zalgiris Kaunas,x,83,77,17,16,23,20,22,20,21,21,33,43,42,42,1
,2025,eurolig,164,Barcelona,x,79,87,23,19,12,30,23,21,21,17,42,42,44,38,-1
,2025,aus,156,Traiskirchen Lions,Swans Gmunden,87,93,12,16,27,31,22,25,26,21,28,58,47,47,1
,2025,aus,160,BBC Nord,Oberwart Gunners,85,87,21,31,20,16,17,19,27,21,52,36,36,48,1
,2025,aus,156,Klosterneuburg Dukes,Kapfenberg Bulls,93,75,34,20,29,24,16,16,14,15,54,53,32,29,-1
,2025,aus,155,Wels,Furstenfeld,75,61,21,9,17,18,14,17,23,17,30,35,31,40,-1
,2025,aus,163,Graz UBSC,St. Polten,85,66,16,13,17,23,26,11,26,19,29,40,37,45,1
,2025,aus,156,Swans Gmunden,x,87,93,12,16,27,31,22,25,26,21,28,58,47,47,1
,2025,aus,160,Oberwart Gunners,x,85,87,21,31,20,16,17,19,27,21,52,36,36,48,1
,2025,aus,156,Kapfenberg Bulls,x,93,75,34,20,29,24,16,16,14,15,54,53,32,29,-1
,2025,aus,155,Furstenfeld,x,75,61,21,9,17,18,14,17,23,17,30,35,31,40,-1
,2025,aus,163,St. Polten,x,85,66,16,13,17,23,26,11,26,19,29,40,37,45,1
,2025,avst,184,Brisbane Bullets,Perth,105,84,25,26,22,13,27,26,31,19,51,35,53,50,1
,2025,avst,181,Melbourne United,Adelaide,113,93,29,22,30,24,26,27,28,20,51,54,53,48,1
,2025,avst,181,Illawarra Hawks,Sydney,86,79,22,22,22,13,23,19,19,25,44,35,42,44,-1
,2025,avst,172,Cairns Taipans,New Zealand Breakers,69,77,23,28,19,24,17,11,10,14,51,43,28,24,-1
,2025,avst,180,Perth,South East Melbourne,97,84,18,26,40,22,18,12,21,24,44,62,30,45,-1
,2025,avst,167,Tasmania JackJumpers,Brisbane Bullets,95,92,20,31,23,15,25,14,27,32,51,38,39,59,1
,2025,avst,184,Perth,x,105,84,25,26,22,13,27,26,31,19,51,35,53,50,1
,2025,avst,181,Adelaide,x,113,93,29,22,30,24,26,27,28,20,51,54,53,48,1
,2025,avst,181,Sydney,x,86,79,22,22,22,13,23,19,19,25,44,35,42,44,-1
,2025,avst,172,New Zealand Breakers,x,69,77,23,28,19,24,17,11,10,14,51,43,28,24,-1
,2025,avst,180,South East Melbourne,x,97,84,18,26,40,22,18,12,21,24,44,62,30,45,-1
,2025,avst,167,Brisbane Bullets,x,95,92,20,31,23,15,25,14,27,32,51,38,39,59,1
,2025,bnxt,162,QSTA Utd,Mechelen,70,82,24,14,10,27,28,19,8,22,38,37,47,30,-1
,2025,bnxt,157,Circus Brussels,Den Bosch,74,73,18,17,16,21,25,19,15,16,35,37,44,31,-1
,2025,bnxt,154,Spirou Charleroi,Donar Groningen,80,68,21,11,17,22,21,16,21,19,32,39,37,40,-1
,2025,bnxt,162,Zwolle,Antwerp Giants,77,81,16,21,17,16,24,20,20,24,37,33,44,44,1
,2025,bnxt,153,Belfius Mons,Den Helder,91,77,22,16,24,17,23,24,22,20,38,41,47,42,1
,2025,bnxt,162,Okapi Aalst,Feyenoord,87,90,20,25,17,17,21,26,29,22,45,34,47,51,1
,2025,bnxt,158,Oostende,Limburg,84,72,22,13,29,20,10,24,23,15,35,49,34,38,-1
,2025,bnxt,156,BAL Weert,Leiden,65,88,13,19,14,24,21,31,17,14,32,38,52,31,1
,2025,bnxt,155,LWD Basket,Leuven Bears,97,81,31,29,26,15,17,22,23,15,60,41,39,38,-1
,2025,bnxt,155,Den Bosch,Leuven Bears,82,76,26,19,23,24,12,15,21,18,45,47,27,39,-1
,2025,bnxt,165,Donar Groningen,QSTA Utd,76,72,22,17,19,20,16,17,19,18,39,39,33,37,-1
,2025,bnxt,154,Antwerp Giants,Circus Brussels,89,76,21,15,24,19,20,21,24,21,36,43,41,45,1
,2025,bnxt,162,Mechelen,x,70,82,24,14,10,27,28,19,8,22,38,37,47,30,-1
,2025,bnxt,157,Den Bosch,x,74,73,18,17,16,21,25,19,15,16,35,37,44,31,-1
,2025,bnxt,154,Donar Groningen,x,80,68,21,11,17,22,21,16,21,19,32,39,37,40,-1
,2025,bnxt,162,Antwerp Giants,x,77,81,16,21,17,16,24,20,20,24,37,33,44,44,1
,2025,bnxt,153,Den Helder,x,91,77,22,16,24,17,23,24,22,20,38,41,47,42,1
,2025,bnxt,162,Feyenoord,x,87,90,20,25,17,17,21,26,29,22,45,34,47,51,1
,2025,bnxt,158,Limburg,x,84,72,22,13,29,20,10,24,23,15,35,49,34,38,-1
,2025,bnxt,156,Leiden,x,65,88,13,19,14,24,21,31,17,14,32,38,52,31,1
,2025,bnxt,155,Leuven Bears,x,97,81,31,29,26,15,17,22,23,15,60,41,39,38,-1
,2025,bnxt,155,Leuven Bears,x,82,76,26,19,23,24,12,15,21,18,45,47,27,39,-1
,2025,bnxt,165,QSTA Utd,x,76,72,22,17,19,20,16,17,19,18,39,39,33,37,-1
,2025,bnxt,154,Circus Brussels,x,89,76,21,15,24,19,20,21,24,21,36,43,41,45,1
,2025,bos,164,Borac Banja Luka,HKK Mostar,105,79,29,32,32,18,30,10,14,19,61,50,40,33,-1
,2025,bos,158,Jahorina,Spars Ilidza,83,75,26,14,19,17,21,27,17,17,40,36,48,34,1
,2025,bos,164,Siroki Brijeg,Sloboda,75,85,21,21,21,15,8,22,22,14,42,36,30,36,-1
,2025,bos,160,Slavija,Posusje,99,50,25,10,20,12,35,13,19,15,35,32,48,34,1
,2025,bos,153,Promo,Radnicki Gorazde,77,73,21,18,23,19,18,12,15,24,39,42,30,39,-1
,2025,bos,163,KK Bosna,Orlovik,96,67,30,14,18,20,29,14,19,19,44,38,43,38,-1
,2025,bos,159,Leotar Trebinje,Mrkonjic Grad,86,79,21,25,18,23,25,19,22,12,46,41,44,34,-1
,2025,bos,164,HKK Mostar,x,105,79,29,32,32,18,30,10,14,19,61,50,40,33,-1
,2025,bos,158,Spars Ilidza,x,83,75,26,14,19,17,21,27,17,17,40,36,48,34,1
,2025,bos,164,Sloboda,x,75,85,21,21,21,15,8,22,22,14,42,36,30,36,-1
,2025,bos,160,Posusje,x,99,50,25,10,20,12,35,13,19,15,35,32,48,34,1
,2025,bos,153,Radnicki Gorazde,x,77,73,21,18,23,19,18,12,15,24,39,42,30,39,-1
,2025,bos,163,Orlovik,x,96,67,30,14,18,20,29,14,19,19,44,38,43,38,-1
,2025,bos,159,Mrkonjic Grad,x,86,79,21,25,18,23,25,19,22,12,46,41,44,34,-1
,2025,bul,160,Minyor,Cherno More,91,74,22,22,27,20,24,15,18,17,44,47,39,35,-1
,2025,bul,162,Spartak Pleven,Balkan,89,96,31,20,19,24,20,36,19,16,51,43,56,35,1
,2025,bul,169,Levski,Beroe,58,66,14,16,10,12,18,19,16,19,30,22,37,35,-1
,2025,bul,159,Rilski Sportist,Academic Plovdiv,87,56,22,15,24,17,16,18,25,6,37,41,34,31,-1
,2025,bul,167,Academic Plovdiv,Shumen,91,77,18,24,29,15,25,20,19,18,42,44,45,37,-1
,2025,bul,165,Cherno More,Spartak Pleven,88,91,23,20,21,27,22,15,14,18,43,48,37,32,-1
,2025,bul,160,Cherno More,x,91,74,22,22,27,20,24,15,18,17,44,47,39,35,-1
,2025,bul,162,Balkan,x,89,96,31,20,19,24,20,36,19,16,51,43,56,35,1
,2025,bul,169,Beroe,x,58,66,14,16,10,12,18,19,16,19,30,22,37,35,-1
,2025,bul,159,Academic Plovdiv,x,87,56,22,15,24,17,16,18,25,6,37,41,34,31,-1
,2025,bul,167,Shumen,x,91,77,18,24,29,15,25,20,19,18,42,44,45,37,-1
,2025,bul,165,Spartak Pleven,x,88,91,23,20,21,27,22,15,14,18,43,48,37,32,-1
,2025,cro,155,Zabok,Dubrovnik,78,77,12,17,17,19,25,19,24,22,29,36,44,46,1
,2025,cro,153,Alkar,Cedevita Junior,63,65,11,24,26,11,14,14,12,16,35,37,28,28,-1
,2025,cro,159,Osijek,Cibona,63,73,8,18,15,13,13,24,27,18,26,28,37,45,1
,2025,cro,166,Dinamo Zagreb,Kvarner,87,78,25,14,22,32,22,14,18,18,39,54,36,36,-1
,2025,cro,152,Zadar,GKK Sibenka,90,64,34,14,21,11,13,17,22,22,48,32,30,44,-1
,2025,cro,160,Cibona,Dubrava,90,80,21,12,19,23,26,16,24,29,33,42,42,53,1
,2025,cro,155,Cedevita Junior,Zadar,65,68,16,19,17,23,11,10,21,16,35,40,21,37,-1
,2025,cro,162,Split,Zabok,89,76,20,19,18,17,21,24,30,16,39,35,45,46,1
,2025,cro,162,Split,x,78,87,27,24,22,25,11,17,18,21,51,47,28,39,-1
,2025,cro,155,Dubrovnik,x,78,77,12,17,17,19,25,19,24,22,29,36,44,46,1
,2025,cro,153,Cedevita Junior,x,63,65,11,24,26,11,14,14,12,16,35,37,28,28,-1
,2025,cro,159,Cibona,x,63,73,8,18,15,13,13,24,27,18,26,28,37,45,1
,2025,cro,166,Kvarner,x,87,78,25,14,22,32,22,14,18,18,39,54,36,36,-1
,2025,cro,152,GKK Sibenka,x,90,64,34,14,21,11,13,17,22,22,48,32,30,44,-1
,2025,cro,160,Dubrava,x,90,80,21,12,19,23,26,16,24,29,33,42,42,53,1
,2025,cro,155,Zadar,x,65,68,16,19,17,23,11,10,21,16,35,40,21,37,-1
,2025,cro,162,Zabok,x,89,76,20,19,18,17,21,24,30,16,39,35,45,46,1
,2025,cek,166,Usti n. Labem,Jindrichuv Hradec,96,91,31,23,20,25,28,20,17,23,54,45,48,40,1
,2025,cek,176,Srsni Pisek,NH Ostrava,89,78,29,21,17,22,14,16,29,19,50,39,30,48,-1
,2025,cek,162,Decin,USK Prague,73,67,22,18,14,19,18,14,19,16,40,33,32,35,-1
,2025,cek,169,Opava,Pardubice,77,76,28,18,15,20,18,22,16,16,46,35,40,32,-1
,2025,cek,154,Slavia Prague,Brno,90,95,25,22,27,21,14,21,24,31,47,48,35,55,1
,2025,cek,173,Olomoucko,Nymburk,69,91,21,23,17,21,13,16,18,31,44,38,29,49,-1
,2025,cek,173,Jindrichuv Hradec,Nymburk,70,108,20,34,14,30,18,19,18,25,54,44,37,43,-1
,2025,cek,166,Jindrichuv Hradec,x,96,91,31,23,20,25,28,20,17,23,54,45,48,40,1
,2025,cek,176,NH Ostrava,x,89,78,29,21,17,22,14,16,29,19,50,39,30,48,-1
,2025,cek,162,USK Prague,x,73,67,22,18,14,19,18,14,19,16,40,33,32,35,-1
,2025,cek,169,Pardubice,x,77,76,28,18,15,20,18,22,16,16,46,35,40,32,-1
,2025,cek,154,Brno,x,90,95,25,22,27,21,14,21,24,31,47,48,35,55,1
,2025,cek,173,Nymburk,x,69,91,21,23,17,21,13,16,18,31,44,38,29,49,-1
,2025,cek,173,Nymburk,x,70,108,20,34,14,30,18,19,18,25,54,44,37,43,-1
,2025,fin,167,Bisons Loimaa,Kataja,78,85,18,23,25,18,21,24,14,20,41,43,45,34,-1
,2025,fin,170,Pyrinto Tampere,Salon Vilpas,81,98,19,20,22,28,17,28,23,22,39,50,45,45,1
,2025,fin,160,UU-Korihait Uusikaupunki,Karhu Basket,89,91,20,24,26,25,24,18,19,24,44,51,42,43,1
,2025,fin,157,BC Nokia,Kouvot Kouvola,72,80,21,23,17,20,22,16,12,21,44,37,38,33,-1
,2025,fin,174,Helsinki Seagulls,KTP Kotka Basket,99,88,25,32,25,21,23,12,26,23,57,46,35,49,-1
,2025,fin,165,Kobrat,Honka,67,84,19,22,14,17,8,26,26,19,41,31,34,45,-1
,2025,fin,159,Honka,Bisons Loimaa,80,88,25,19,24,16,19,25,12,28,44,40,44,40,1
,2025,fin,164,KTP Kotka Basket,BC Nokia,82,77,21,13,19,26,19,14,23,24,34,45,33,47,-1
,2025,fin,167,Kataja,x,78,85,18,23,25,18,21,24,14,20,41,43,45,34,-1
,2025,fin,170,Salon Vilpas,x,81,98,19,20,22,28,17,28,23,22,39,50,45,45,1
,2025,fin,160,Karhu Basket,x,89,91,20,24,26,25,24,18,19,24,44,51,42,43,1
,2025,fin,157,Kouvot Kouvola,x,72,80,21,23,17,20,22,16,12,21,44,37,38,33,-1
,2025,fin,174,KTP Kotka Basket,x,99,88,25,32,25,21,23,12,26,23,57,46,35,49,-1
,2025,fin,165,Honka,x,67,84,19,22,14,17,8,26,26,19,41,31,34,45,-1
,2025,fin,159,Bisons Loimaa,x,80,88,25,19,24,16,19,25,12,28,44,40,44,40,1
,2025,fin,164,BC Nokia,x,82,77,21,13,19,26,19,14,23,24,34,45,33,47,-1
,2025,fra,173,Paris,Strasbourg,106,74,22,16,31,16,24,21,29,21,38,47,45,50,1
,2025,fra,159,Gravelines-Dunkerque,Lyon-Villeurbanne,60,81,15,26,12,16,14,19,19,20,41,28,33,39,-1
,2025,fra,162,Monaco,Le Mans,74,86,17,24,18,21,18,15,21,26,41,39,33,47,-1
,2025,fra,158,Cholet,Le Portel,80,65,30,20,18,14,15,18,17,13,50,32,33,30,-1
,2025,fra,161,Dijon,Saint Quentin,85,91,12,26,31,26,20,20,22,19,38,57,40,41,1
,2025,fra,167,Chalon/Saone,JL Bourg,86,93,22,23,21,20,17,31,26,19,45,41,48,45,1
,2025,fra,163,Nancy,Limoges,90,86,21,14,18,19,17,18,19,24,35,37,35,43,-1
,2025,fra,158,La Rochelle,Nanterre,77,98,17,22,25,19,20,29,15,28,39,44,49,43,1
,2025,fra b,169,Chartres,Ada Blois,92,91,21,20,30,17,22,25,19,29,41,47,47,48,1
,2025,fra b,161,Pau-Orthez,Orleans,68,78,13,18,16,24,15,14,24,22,31,40,29,46,-1
,2025,fra b,153,Vichy,Antibes,93,64,22,18,29,14,15,15,27,17,40,43,30,44,-1
,2025,fra b,162,Aix Maurienne,Boulazac,80,91,21,20,19,25,26,18,14,28,41,44,44,42,1
,2025,fra b,161,Denain-Voltaire,Chalons-Reims,88,82,21,21,21,17,22,21,24,23,42,38,43,47,1
,2025,fra b,161,Evreux,Caen,65,70,14,18,9,17,17,17,25,18,32,26,34,43,-1
,2025,fra b,160,Fos-sur-Mer,ASA,83,96,20,17,20,36,15,23,28,20,37,56,38,48,1
,2025,fra b,168,Poitiers,St. Chamond,93,87,22,16,33,20,25,23,13,28,38,53,48,41,1
,2025,fra b,163,Roanne,Hyeres-Toulon,90,73,20,20,19,23,24,15,27,15,40,42,39,42,-1
,2025,fra b,164,Rouen,Nantes,101,66,26,10,14,16,32,17,29,23,36,30,49,52,1
,2025,fra b,158,Ada Blois,Pau-Orthez,102,105,23,21,24,24,24,23,18,21,44,48,47,39,1
,2025,fra,173,Strasbourg,x,106,74,22,16,31,16,24,21,29,21,38,47,45,50,1
,2025,fra,159,Lyon-Villeurbanne,x,60,81,15,26,12,16,14,19,19,20,41,28,33,39,-1
,2025,fra,162,Le Mans,x,74,86,17,24,18,21,18,15,21,26,41,39,33,47,-1
,2025,fra,158,Le Portel,x,80,65,30,20,18,14,15,18,17,13,50,32,33,30,-1
,2025,fra,161,Saint Quentin,x,85,91,12,26,31,26,20,20,22,19,38,57,40,41,1
,2025,fra,167,JL Bourg,x,86,93,22,23,21,20,17,31,26,19,45,41,48,45,1
,2025,fra,163,Limoges,x,90,86,21,14,18,19,17,18,19,24,35,37,35,43,-1
,2025,fra,158,Nanterre,x,77,98,17,22,25,19,20,29,15,28,39,44,49,43,1
,2025,fra b,169,Ada Blois,x,92,91,21,20,30,17,22,25,19,29,41,47,47,48,1
,2025,fra b,161,Orleans,x,68,78,13,18,16,24,15,14,24,22,31,40,29,46,-1
,2025,fra b,153,Antibes,x,93,64,22,18,29,14,15,15,27,17,40,43,30,44,-1
,2025,fra b,162,Boulazac,x,80,91,21,20,19,25,26,18,14,28,41,44,44,42,1
,2025,fra b,161,Chalons-Reims,x,88,82,21,21,21,17,22,21,24,23,42,38,43,47,1
,2025,fra b,161,Caen,x,65,70,14,18,9,17,17,17,25,18,32,26,34,43,-1
,2025,fra b,160,ASA,x,83,96,20,17,20,36,15,23,28,20,37,56,38,48,1
,2025,fra b,168,St. Chamond,x,93,87,22,16,33,20,25,23,13,28,38,53,48,41,1
,2025,fra b,163,Hyeres-Toulon,x,90,73,20,20,19,23,24,15,27,15,40,42,39,42,-1
,2025,fra b,164,Nantes,x,101,66,26,10,14,16,32,17,29,23,36,30,49,52,1
,2025,fra b,158,Pau-Orthez,x,102,105,23,21,24,24,24,23,18,21,44,48,47,39,1
,2025,ger b,169,Tubingen,Vechta 2,85,69,16,25,19,11,30,17,20,16,41,30,47,36,-1
,2025,ger b,164,Trier,Munster,92,70,21,14,25,25,24,17,22,14,35,50,41,36,-1
,2025,ger b,167,Crailsheim Merlins,Bochum,87,94,27,19,17,24,17,23,26,28,46,41,40,54,1
,2025,ger b,167,Artland,Bremerhaven,74,81,22,22,9,27,22,13,21,19,44,36,35,40,-1
,2025,ger b,157,PS Karlsruhe,Jena,72,104,11,30,14,17,27,30,20,27,41,31,57,47,1
,2025,ger b,157,Dusseldorf,Koblenz,84,87,19,19,23,23,22,19,20,26,38,46,41,46,1
,2025,ger b,161,Giessen,Dresden,97,68,22,13,22,19,24,23,29,13,35,41,47,42,1
,2025,ger b,167,Kirchheim,Bayreuth,74,93,8,9,18,26,26,31,22,27,17,44,57,49,1
,2025,ger b,159,Nurnberger,Phoenix Hagen,80,71,22,11,18,20,19,20,21,20,33,38,39,41,1
,2025,ger b,169,Tubingen,Vechta 2,85,69,16,25,19,11,30,17,20,16,41,30,47,36,-1
,2025,ger b,164,Trier,Munster,92,70,21,14,25,25,24,17,22,14,35,50,41,36,-1
,2025,ger b,167,Crailsheim Merlins,Bochum,87,94,27,19,17,24,17,23,26,28,46,41,40,54,1
,2025,ger b,167,Artland,Bremerhaven,74,81,22,22,9,27,22,13,21,19,44,36,35,40,-1
,2025,ger b,157,PS Karlsruhe,Jena,72,104,11,30,14,17,27,30,20,27,41,31,57,47,1
,2025,ger b,157,Dusseldorf,Koblenz,84,87,19,19,23,23,22,19,20,26,38,46,41,46,1
,2025,ger b,161,Giessen,Dresden,97,68,22,13,22,19,24,23,29,13,35,41,47,42,1
,2025,ger b,167,Kirchheim,Bayreuth,74,93,8,9,18,26,26,31,22,27,17,44,57,49,1
,2025,ger b,159,Nurnberger,Phoenix Hagen,80,71,22,11,18,20,19,20,21,20,33,38,39,41,1
,2025,ger,154,Ludwigsburg,Wurzburg,82,91,18,18,15,17,25,28,24,28,36,32,53,52,1
,2025,ger,166,Vechta,Alba Berlin,96,93,22,33,29,17,19,16,26,27,55,46,35,53,1
,2025,ger,165,Bayern,Bonn,93,73,22,20,28,17,24,17,19,19,42,45,41,38,-1
,2025,ger,170,Ulm,Gottingen,109,70,26,14,34,21,27,22,22,13,40,55,49,35,-1
,2025,ger,161,Oldenburg,Frankfurt,102,92,16,23,28,16,17,17,23,28,39,44,34,51,1
,2025,ger,157,Basketball Braunschweig,Chemnitz,82,74,14,22,28,17,23,19,17,16,36,45,42,33,-1
,2025,ger,167,Syntainics MBC,Bamberg,99,94,28,14,26,25,19,28,26,27,42,51,47,53,1
,2025,ger,169,Heidelberg,Hamburg,73,68,26,10,11,22,11,22,25,14,36,33,33,39,-1
,2025,ger b,169,Vechta 2,x,85,69,16,25,19,11,30,17,20,16,41,30,47,36,-1
,2025,ger b,164,Munster,x,92,70,21,14,25,25,24,17,22,14,35,50,41,36,-1
,2025,ger b,167,Bochum,x,87,94,27,19,17,24,17,23,26,28,46,41,40,54,1
,2025,ger b,167,Bremerhaven,x,74,81,22,22,9,27,22,13,21,19,44,36,35,40,-1
,2025,ger b,157,Jena,x,72,104,11,30,14,17,27,30,20,27,41,31,57,47,1
,2025,ger b,157,Koblenz,x,84,87,19,19,23,23,22,19,20,26,38,46,41,46,1
,2025,ger b,161,Dresden,x,97,68,22,13,22,19,24,23,29,13,35,41,47,42,1
,2025,ger b,167,Bayreuth,x,74,93,8,9,18,26,26,31,22,27,17,44,57,49,1
,2025,ger b,159,Phoenix Hagen,x,80,71,22,11,18,20,19,20,21,20,33,38,39,41,1
,2025,ger b,169,Vechta 2,x,85,69,16,25,19,11,30,17,20,16,41,30,47,36,-1
,2025,ger b,164,Munster,x,92,70,21,14,25,25,24,17,22,14,35,50,41,36,-1
,2025,ger b,167,Bochum,x,87,94,27,19,17,24,17,23,26,28,46,41,40,54,1
,2025,ger b,167,Bremerhaven,x,74,81,22,22,9,27,22,13,21,19,44,36,35,40,-1
,2025,ger b,157,Jena,x,72,104,11,30,14,17,27,30,20,27,41,31,57,47,1
,2025,ger b,157,Koblenz,x,84,87,19,19,23,23,22,19,20,26,38,46,41,46,1
,2025,ger b,161,Dresden,x,97,68,22,13,22,19,24,23,29,13,35,41,47,42,1
,2025,ger b,167,Bayreuth,x,74,93,8,9,18,26,26,31,22,27,17,44,57,49,1
,2025,ger b,159,Phoenix Hagen,x,80,71,22,11,18,20,19,20,21,20,33,38,39,41,1
,2025,ger,154,Wurzburg,x,82,91,18,18,15,17,25,28,24,28,36,32,53,52,1
,2025,ger,166,Alba Berlin,x,96,93,22,33,29,17,19,16,26,27,55,46,35,53,1
,2025,ger,165,Bonn,x,93,73,22,20,28,17,24,17,19,19,42,45,41,38,-1
,2025,ger,170,Gottingen,x,109,70,26,14,34,21,27,22,22,13,40,55,49,35,-1
,2025,ger,161,Frankfurt,x,102,92,16,23,28,16,17,17,23,28,39,44,34,51,1
,2025,ger,157,Chemnitz,x,82,74,14,22,28,17,23,19,17,16,36,45,42,33,-1
,2025,ger,167,Bamberg,x,99,94,28,14,26,25,19,28,26,27,42,51,47,53,1
,2025,ger,169,Hamburg,x,73,68,26,10,11,22,11,22,25,14,36,33,33,39,-1
,2025,greek,163,PAOK,Olympiacos,60,90,13,29,13,24,17,24,17,13,42,37,41,30,-1
,2025,greek,164,Maroussi,Lavrio,80,84,16,15,17,26,26,12,21,31,31,43,38,52,1
,2025,greek,158,Kolossos Rhodes,Panathinaikos,84,91,22,22,25,19,20,24,17,26,44,44,44,43,1
,2025,greek,148,Panionios,Aris,79,62,18,16,26,11,15,15,20,20,34,37,30,40,-1
,2025,greek,156,Peristeri,AS Karditsas,71,78,19,28,19,21,19,13,14,16,47,40,32,30,-1
,2025,greek,165,Promitheas,AEK Athens,84,76,20,14,15,23,32,18,17,21,34,38,50,38,1
,2025,greek,163,Olympiacos,x,60,90,13,29,13,24,17,24,17,13,42,37,41,30,-1
,2025,greek,164,Lavrio,x,80,84,16,15,17,26,26,12,21,31,31,43,38,52,1
,2025,greek,158,Panathinaikos,x,84,91,22,22,25,19,20,24,17,26,44,44,44,43,1
,2025,greek,148,Aris,x,79,62,18,16,26,11,15,15,20,20,34,37,30,40,-1
,2025,greek,156,AS Karditsas,x,71,78,19,28,19,21,19,13,14,16,47,40,32,30,-1
,2025,greek,165,AEK Athens,x,84,76,20,14,15,23,32,18,17,21,34,38,50,38,1
,2025,lat-st,163,Rigas Zelli,Valmiera Glass Via,72,61,20,21,13,15,21,14,18,11,41,28,35,29,-1
,2025,lat-st,158,BK Ogre,Parnu,76,87,23,19,21,28,17,22,15,18,42,49,39,33,-1
,2025,lat-st,152,Tartu Ulikool,Latvijas Universitate,88,74,21,17,32,23,21,14,14,20,38,55,35,34,-1
,2025,lat-st,158,Viimsi,Tal Tech,70,88,23,21,13,20,12,22,22,25,44,33,34,47,1
,2025,lat-st,167,VEF Riga,Ventspils,71,63,18,25,12,14,17,15,24,9,43,26,32,33,-1
,2025,lat-st,162,BK Liepaja,Keila KK,83,82,27,12,17,23,21,30,18,17,39,40,51,35,1
,2025,lat-st,157,Rapla,BC Kalev/Cramo,75,87,18,27,19,22,22,15,16,23,45,41,37,39,-1
,2025,lat-st,155,Tartu Ulikool,Rapla,90,84,17,14,16,24,22,14,18,21,31,40,36,39,-1
,2025,lat-st,159,Valmiera Glass Via,BK Ogre,88,92,20,29,15,20,29,24,24,19,49,35,53,43,1
,2025,lat-st,165,Latvijas Universitate,Ventspils,87,89,19,11,23,30,16,33,29,15,30,53,49,44,1
,2025,lat lkl,167,Jonava,Lietkabelis,84,82,16,26,21,20,22,24,25,12,42,41,46,37,-1
,2025,lat lkl,181,Rytas,BC Wolves,71,82,15,11,22,15,17,29,17,27,26,37,46,44,-1
,2025,lat lkl,165,Zalgiris Kaunas,Mazeikiai,101,46,26,8,26,13,24,12,25,13,34,39,36,38,-1
,2025,lat lkl,177,Juventus,Siauliai,101,88,27,17,25,22,24,28,25,21,44,47,52,46,1
,2025,lat lkl,177,Nevezis,Neptunas,74,83,18,18,26,31,16,16,14,18,36,57,32,32,-1
,2025,lat nkl,163,Kretinga,Telsiai,66,93,15,31,19,24,12,14,20,24,46,43,26,44,-1
,2025,lat nkl,153,BC Olimpas Palanga,Omega-Tauras,74,52,12,12,19,15,25,16,18,9,24,34,41,27,-1
,2025,lat nkl,166,Delikatesas Joniskis,Kretinga,106,88,30,25,25,23,21,17,30,23,55,48,38,53,1
,2025,lat nkl,161,Neptunas 2,Alytaus Alytus,80,83,16,19,22,25,27,19,15,20,35,47,46,35,1
,2025,lat nkl,160,Plunges Olimpas,Vilkaviskis,93,88,19,22,22,16,17,27,35,23,41,38,44,58,1
,2025,lat nkl,165,Rytas 2,Telsiai,73,84,22,24,15,22,19,15,17,23,46,37,34,40,-1
,2025,lat nkl,156,Suduva-Mantinga,Ukmerges Stekas,72,67,18,22,19,12,19,12,16,21,40,31,31,37,-1
,2025,lat nkl,169,Vytis VDU,Silute,94,74,29,10,15,16,27,19,23,29,39,31,46,52,1
,2025,lat nkl,157,Zalgiris Kaunas 2,Jurbarkas,79,83,15,18,17,23,30,22,17,20,33,40,52,37,1
,2025,lat nkl,160,Jurbarkas,Plunges Olimpas,74,64,20,14,22,11,15,22,17,17,34,33,37,34,-1
,2025,lat nkl,162,Kretinga,Rytas 2,80,101,31,23,16,28,15,23,18,27,54,44,38,45,1
,2025,lat nkl,150,Ukmerges Stekas,BC Olimpas Palanga,66,83,20,15,7,22,21,23,18,23,35,29,44,41,1
,2025,lat nkl,167,Alytaus Alytus,Delikatesas Joniskis,112,101,29,23,25,28,18,24,24,21,52,53,42,45,1
,2025,lat nkl,158,Omega-Tauras,Zalgiris Kaunas 2,80,76,27,22,19,15,22,17,12,22,49,34,39,34,-1
,2025,lat nkl,157,Silute,Neptunas 2,80,69,26,16,19,22,23,14,12,17,42,41,37,29,-1
,2025,lat nkl,162,Telsiai,Suduva-Mantinga,84,61,23,13,19,14,23,14,19,20,36,33,37,39,-1
,2025,lat nkl,171,Vilkaviskis,Vytis VDU,79,83,26,21,15,29,17,15,21,18,47,44,32,39,-1
,2025,lat-st,163,Valmiera Glass Via,x,72,61,20,21,13,15,21,14,18,11,41,28,35,29,-1
,2025,lat-st,158,Parnu,x,76,87,23,19,21,28,17,22,15,18,42,49,39,33,-1
,2025,lat-st,152,Latvijas Universitate,x,88,74,21,17,32,23,21,14,14,20,38,55,35,34,-1
,2025,lat-st,158,Tal Tech,x,70,88,23,21,13,20,12,22,22,25,44,33,34,47,1
,2025,lat-st,167,Ventspils,x,71,63,18,25,12,14,17,15,24,9,43,26,32,33,-1
,2025,lat-st,162,Keila KK,x,83,82,27,12,17,23,21,30,18,17,39,40,51,35,1
,2025,lat-st,157,BC Kalev/Cramo,x,75,87,18,27,19,22,22,15,16,23,45,41,37,39,-1
,2025,lat-st,155,Rapla,x,90,84,17,14,16,24,22,14,18,21,31,40,36,39,-1
,2025,lat-st,159,BK Ogre,x,88,92,20,29,15,20,29,24,24,19,49,35,53,43,1
,2025,lat-st,165,Ventspils,x,87,89,19,11,23,30,16,33,29,15,30,53,49,44,1
,2025,lat lkl,167,Lietkabelis,x,84,82,16,26,21,20,22,24,25,12,42,41,46,37,-1
,2025,lat lkl,181,BC Wolves,x,71,82,15,11,22,15,17,29,17,27,26,37,46,44,-1
,2025,lat lkl,165,Mazeikiai,x,101,46,26,8,26,13,24,12,25,13,34,39,36,38,-1
,2025,lat lkl,177,Siauliai,x,101,88,27,17,25,22,24,28,25,21,44,47,52,46,1
,2025,lat lkl,177,Neptunas,x,74,83,18,18,26,31,16,16,14,18,36,57,32,32,-1
,2025,lat nkl,163,Telsiai,x,66,93,15,31,19,24,12,14,20,24,46,43,26,44,-1
,2025,lat nkl,153,Omega-Tauras,x,74,52,12,12,19,15,25,16,18,9,24,34,41,27,-1
,2025,lat nkl,166,Kretinga,x,106,88,30,25,25,23,21,17,30,23,55,48,38,53,1
,2025,lat nkl,161,Alytaus Alytus,x,80,83,16,19,22,25,27,19,15,20,35,47,46,35,1
,2025,lat nkl,160,Vilkaviskis,x,93,88,19,22,22,16,17,27,35,23,41,38,44,58,1
,2025,lat nkl,165,Telsiai,x,73,84,22,24,15,22,19,15,17,23,46,37,34,40,-1
,2025,lat nkl,156,Ukmerges Stekas,x,72,67,18,22,19,12,19,12,16,21,40,31,31,37,-1
,2025,lat nkl,169,Silute,x,94,74,29,10,15,16,27,19,23,29,39,31,46,52,1
,2025,lat nkl,157,Jurbarkas,x,79,83,15,18,17,23,30,22,17,20,33,40,52,37,1
,2025,lat nkl,160,Plunges Olimpas,x,74,64,20,14,22,11,15,22,17,17,34,33,37,34,-1
,2025,lat nkl,162,Rytas 2,x,80,101,31,23,16,28,15,23,18,27,54,44,38,45,1
,2025,lat nkl,150,BC Olimpas Palanga,x,66,83,20,15,7,22,21,23,18,23,35,29,44,41,1
,2025,lat nkl,167,Delikatesas Joniskis,x,112,101,29,23,25,28,18,24,24,21,52,53,42,45,1
,2025,lat nkl,158,Zalgiris Kaunas 2,x,80,76,27,22,19,15,22,17,12,22,49,34,39,34,-1
,2025,lat nkl,157,Neptunas 2,x,80,69,26,16,19,22,23,14,12,17,42,41,37,29,-1
,2025,lat nkl,162,Suduva-Mantinga,x,84,61,23,13,19,14,23,14,19,20,36,33,37,39,-1
,2025,lat nkl,171,Vytis VDU,x,79,83,26,21,15,29,17,15,21,18,47,44,32,39,-1
,2025,ita,156,Cremona,Olimpia Milano,83,95,16,28,22,26,29,16,16,25,44,48,45,41,1
,2025,ita,162,Virtus Bologna,Sassari,95,85,21,18,16,23,37,23,21,21,39,39,60,42,1
,2025,ita,174,Basket Napoli,Treviso,69,84,15,15,22,22,16,18,16,29,30,44,34,45,-1
,2025,ita,153,Venezia,Reggiana,59,62,13,15,15,16,11,15,20,16,28,31,26,36,-1
,2025,ita,168,Tortona,Brescia,78,85,23,29,22,20,21,15,12,21,52,42,36,33,-1
,2025,ita,159,Pistoia,Trento,88,92,21,22,27,23,24,27,16,20,43,50,51,36,1
,2025,ita,173,Trieste,Trapani,93,98,20,23,25,27,20,22,28,26,43,52,42,54,1
,2025,ita,187,Scafati,Varese,94,85,27,25,22,25,18,21,27,14,52,47,39,41,-1
,2025,ita b,150,Brindisi,Assigeco Piacenza,79,68,26,17,13,22,15,12,25,17,43,35,27,42,-1
,2025,ita b,154,Avellino Basket,Nardo,92,74,25,25,24,20,24,15,19,14,50,44,39,33,-1
,2025,ita b,153,Basket Torino,Urania Milano,71,81,17,19,23,21,20,24,11,17,36,44,44,28,-1
,2025,ita b,149,Forli,Cantu,71,76,16,20,21,15,25,21,9,20,36,36,46,29,1
,2025,ita b,153,JuVi Cremona,Sebastiani Rieti,97,83,28,24,20,24,27,17,22,18,52,44,44,40,1
,2025,ita b,156,Libertas Livorno,Rimini,74,78,19,25,14,14,17,18,24,21,44,28,35,45,1
,2025,ita b,159,Orzinuovi,Verona,72,64,13,14,17,16,20,21,22,13,27,33,41,35,-1
,2025,ita b,149,Pesaro,Cento,78,60,17,12,20,17,19,11,22,20,29,37,30,42,-1
,2025,ita b,155,Udine,Vigevano,93,87,15,25,23,24,28,15,27,23,40,47,43,50,1
,2025,ita b,149,Cividale,Fortitudo Bologna,86,75,23,10,19,20,21,23,23,22,33,39,44,45,1
,2025,ita b,152,Urania Milano,Brindisi,74,63,11,16,19,10,30,21,14,16,27,29,51,30,1
,2025,ita b,157,Rimini,Avellino Basket,80,78,25,21,17,19,16,19,22,19,46,36,35,41,-1
,2025,ita b,150,Sebastiani Rieti,Verona,58,60,16,23,15,10,11,16,16,11,39,25,27,27,-1
,2025,ita b,148,Cantu,Fortitudo Bologna,89,60,22,16,31,13,18,20,18,11,38,44,38,29,-1
,2025,ita b,149,Libertas Livorno,Pesaro,104,78,26,13,34,15,15,21,29,29,39,49,36,58,1
,2025,ita b,154,Assigeco Piacenza,Cividale,75,80,21,26,14,14,20,15,20,25,47,28,35,45,1
,2025,ita b,155,Cento,JuVi Cremona,88,87,24,26,15,23,33,19,16,19,50,38,52,35,1
,2025,ita b,155,Nardo,Basket Torino,68,74,20,13,15,11,17,25,16,25,33,26,42,41,1
,2025,ita b,157,Orzinuovi,Vigevano,100,98,27,18,27,19,21,21,16,33,45,46,42,49,1
,2025,ita b,147,Udine,Forli,84,75,27,14,23,20,22,13,12,28,41,43,35,40,1
,2025,ita,156,Olimpia Milano,x,83,95,16,28,22,26,29,16,16,25,44,48,45,41,1
,2025,ita,162,Sassari,x,95,85,21,18,16,23,37,23,21,21,39,39,60,42,1
,2025,ita,174,Treviso,x,69,84,15,15,22,22,16,18,16,29,30,44,34,45,-1
,2025,ita,153,Reggiana,x,59,62,13,15,15,16,11,15,20,16,28,31,26,36,-1
,2025,ita,168,Brescia,x,78,85,23,29,22,20,21,15,12,21,52,42,36,33,-1
,2025,ita,159,Trento,x,88,92,21,22,27,23,24,27,16,20,43,50,51,36,1
,2025,ita,173,Trapani,x,93,98,20,23,25,27,20,22,28,26,43,52,42,54,1
,2025,ita,187,Varese,x,94,85,27,25,22,25,18,21,27,14,52,47,39,41,-1
,2025,ita b,150,Assigeco Piacenza,x,79,68,26,17,13,22,15,12,25,17,43,35,27,42,-1
,2025,ita b,154,Nardo,x,92,74,25,25,24,20,24,15,19,14,50,44,39,33,-1
,2025,ita b,153,Urania Milano,x,71,81,17,19,23,21,20,24,11,17,36,44,44,28,-1
,2025,ita b,149,Cantu,x,71,76,16,20,21,15,25,21,9,20,36,36,46,29,1
,2025,ita b,153,Sebastiani Rieti,x,97,83,28,24,20,24,27,17,22,18,52,44,44,40,1
,2025,ita b,156,Rimini,x,74,78,19,25,14,14,17,18,24,21,44,28,35,45,1
,2025,ita b,159,Verona,x,72,64,13,14,17,16,20,21,22,13,27,33,41,35,-1
,2025,ita b,149,Cento,x,78,60,17,12,20,17,19,11,22,20,29,37,30,42,-1
,2025,ita b,155,Vigevano,x,93,87,15,25,23,24,28,15,27,23,40,47,43,50,1
,2025,ita b,149,Fortitudo Bologna,x,86,75,23,10,19,20,21,23,23,22,33,39,44,45,1
,2025,ita b,152,Brindisi,x,74,63,11,16,19,10,30,21,14,16,27,29,51,30,1
,2025,ita b,157,Avellino Basket,x,80,78,25,21,17,19,16,19,22,19,46,36,35,41,-1
,2025,ita b,150,Verona,x,58,60,16,23,15,10,11,16,16,11,39,25,27,27,-1
,2025,ita b,148,Fortitudo Bologna,x,89,60,22,16,31,13,18,20,18,11,38,44,38,29,-1
,2025,ita b,149,Pesaro,x,104,78,26,13,34,15,15,21,29,29,39,49,36,58,1
,2025,ita b,154,Cividale,x,75,80,21,26,14,14,20,15,20,25,47,28,35,45,1
,2025,ita b,155,JuVi Cremona,x,88,87,24,26,15,23,33,19,16,19,50,38,52,35,1
,2025,ita b,155,Basket Torino,x,68,74,20,13,15,11,17,25,16,25,33,26,42,41,1
,2025,ita b,157,Vigevano,x,100,98,27,18,27,19,21,21,16,33,45,46,42,49,1
,2025,ita b,147,Forli,x,84,75,27,14,23,20,22,13,12,28,41,43,35,40,1
,2025,mak,163,Pelister,Shkupi Skopje,86,90,21,20,24,25,14,19,27,26,41,49,33,53,1
,2025,mak,161,TFT Skopje,Cair 2030,92,94,21,11,23,20,13,21,25,30,32,43,34,55,1
,2025,mak,158,Gostivar,Kozuv,66,68,18,26,21,16,17,11,10,15,44,37,28,25,-1
,2025,mak,159,MKK Kumanovo,Feniks 2010,73,66,20,24,18,11,19,20,16,11,44,29,39,27,-1
,2025,mak,160,Tikvesh,Rabotnicki,81,85,18,21,19,22,24,23,20,19,39,41,47,39,1
,2025,mak,155,Vardar,MZT Skopje,79,110,27,22,13,27,15,28,24,33,49,40,43,57,1
,2025,mak,163,Shkupi Skopje,x,86,90,21,20,24,25,14,19,27,26,41,49,33,53,1
,2025,mak,161,Cair 2030,x,92,94,21,11,23,20,13,21,25,30,32,43,34,55,1
,2025,mak,158,Kozuv,x,66,68,18,26,21,16,17,11,10,15,44,37,28,25,-1
,2025,mak,159,Feniks 2010,x,73,66,20,24,18,11,19,20,16,11,44,29,39,27,-1
,2025,mak,160,Rabotnicki,x,81,85,18,21,19,22,24,23,20,19,39,41,47,39,1
,2025,mak,155,MZT Skopje,x,79,110,27,22,13,27,15,28,24,33,49,40,43,57,1
,2025,pol,152,Spojnia Stargard,Gornik Walbrzych,81,80,24,19,29,20,13,21,15,20,43,49,34,35,-1
,2025,pol,170,Szczecin,Lublin,81,82,27,24,21,18,14,15,19,25,51,39,29,44,-1
,2025,pol,174,Trefl Sopot,Dabrowa Gornicza,92,68,30,20,27,12,19,20,16,16,50,39,39,32,-1
,2025,pol,173,Anwil Wloclawek,Torun,83,66,19,14,13,13,24,26,27,13,33,26,50,40,1
,2025,pol,163,Ostrow Wielkopolski,Legia,75,90,20,23,23,29,20,16,12,22,43,52,36,34,-1
,2025,pol,163,Zielona Gora,Slask Wroclaw,82,88,16,20,20,29,9,22,37,17,36,49,31,54,1
,2025,pol,164,Gdynia,Dziki Warszawa,69,82,18,16,10,29,25,11,16,26,34,39,36,42,-1
,2025,pol,165,Czarni Slupsk,GTK Gliwice,98,84,21,12,24,23,27,17,26,32,33,47,44,58,1
,2025,pol,152,Gornik Walbrzych,x,81,80,24,19,29,20,13,21,15,20,43,49,34,35,-1
,2025,pol,170,Lublin,x,81,82,27,24,21,18,14,15,19,25,51,39,29,44,-1
,2025,pol,174,Dabrowa Gornicza,x,92,68,30,20,27,12,19,20,16,16,50,39,39,32,-1
,2025,pol,173,Torun,x,83,66,19,14,13,13,24,26,27,13,33,26,50,40,1
,2025,pol,163,Legia,x,75,90,20,23,23,29,20,16,12,22,43,52,36,34,-1
,2025,pol,163,Slask Wroclaw,x,82,88,16,20,20,29,9,22,37,17,36,49,31,54,1
,2025,pol,164,Dziki Warszawa,x,69,82,18,16,10,29,25,11,16,26,34,39,36,42,-1
,2025,pol,165,GTK Gliwice,x,98,84,21,12,24,23,27,17,26,32,33,47,44,58,1
,2025,por,159,Oliveirense,Esgueira,93,77,18,18,27,23,21,21,27,15,36,50,42,42,1
,2025,por,161,Vitoria,Ovarense,62,67,25,11,14,20,12,23,11,13,36,34,35,24,-1
,2025,por,168,Benfica,CA Queluz,108,82,28,16,30,17,28,27,22,22,44,47,55,44,1
,2025,por,153,CD Povoa,Galomar,81,72,26,16,15,23,19,16,21,17,42,38,35,38,-1
,2025,por,158,Imortal,FC Porto,79,93,14,23,26,14,20,32,19,24,37,40,52,43,1
,2025,por,160,Sporting CP,Galitos Barreiro,76,72,18,13,16,23,25,22,17,14,31,39,47,31,-1
,2025,por,167,CA Queluz,Vitoria,79,86,29,29,14,18,19,19,17,20,58,32,38,37,-1
,2025,por,159,Esgueira,x,93,77,18,18,27,23,21,21,27,15,36,50,42,42,1
,2025,por,161,Ovarense,x,62,67,25,11,14,20,12,23,11,13,36,34,35,24,-1
,2025,por,168,CA Queluz,x,108,82,28,16,30,17,28,27,22,22,44,47,55,44,1
,2025,por,153,Galomar,x,81,72,26,16,15,23,19,16,21,17,42,38,35,38,-1
,2025,por,158,FC Porto,x,79,93,14,23,26,14,20,32,19,24,37,40,52,43,1
,2025,por,160,Galitos Barreiro,x,76,72,18,13,16,23,25,22,17,14,31,39,47,31,-1
,2025,por,167,Vitoria,x,79,86,29,29,14,18,19,19,17,20,58,32,38,37,-1
,2025,por b,142,Imortal B,Santo Andre,68,58,12,13,16,15,21,15,19,15,25,31,36,34,-1
,2025,por b,141,Benfica Lisboa B,Portimonense,72,79,7,25,26,16,16,18,23,20,32,42,34,43,1
,2025,por b,146,Braga,Galitos Aveiro,79,51,23,8,13,16,16,21,27,6,31,29,37,33,-1
,2025,por b,142,Barreirense,CB Queluz,75,86,18,28,20,23,18,22,19,13,46,43,40,32,1
,2025,por b,140,CAB Madeira,Lusitania,86,73,16,18,14,20,25,18,31,17,34,34,43,48,1
,2025,por b,153,Illiabum,Vasco Da Gama,67,79,13,21,14,16,13,23,27,19,34,30,36,46,1
,2025,por b,158,Maia,Sampaense,83,75,23,15,14,16,28,15,18,29,38,30,43,47,1
,2025,por b,153,Ginasio,Sangalhos,82,80,15,21,25,25,19,18,23,16,36,50,37,39,-1
,2025,por b,142,Santo Andre,x,68,58,12,13,16,15,21,15,19,15,25,31,36,34,-1
,2025,por b,141,Portimonense,x,72,79,7,25,26,16,16,18,23,20,32,42,34,43,1
,2025,por b,146,Galitos Aveiro,x,79,51,23,8,13,16,16,21,27,6,31,29,37,33,-1
,2025,por b,142,CB Queluz,x,75,86,18,28,20,23,18,22,19,13,46,43,40,32,1
,2025,por b,140,Lusitania,x,86,73,16,18,14,20,25,18,31,17,34,34,43,48,1
,2025,por b,153,Vasco Da Gama,x,67,79,13,21,14,16,13,23,27,19,34,30,36,46,1
,2025,por b,158,Sampaense,x,83,75,23,15,14,16,28,15,18,29,38,30,43,47,1
,2025,por b,153,Sangalhos,x,82,80,15,21,25,25,19,18,23,16,36,50,37,39,-1
,2025,sır,176,OKK Beograd,OKK Novi Pazar,111,75,24,21,25,23,28,13,34,18,45,48,41,52,1
,2025,sır,164,Tamis,Joker,94,85,28,26,22,23,22,17,22,19,54,45,39,41,-1
,2025,sır,161,Zlatibor,Radnicki,72,98,16,23,17,21,16,36,23,18,39,38,52,41,1
,2025,sır,162,Sloga,BBK Radnicki,88,84,19,20,29,17,23,21,17,26,39,46,44,43,1
,2025,sır,166,KK Metalac,Vojvodina Novi Sad,67,80,21,22,11,26,24,18,11,14,43,37,42,25,-1
,2025,sır,161,KK Mladost SP,Mladost Zemun,70,91,17,26,13,23,21,20,19,22,43,36,41,41,1
,2025,sır,165,Sloboda,Vrsac,79,67,24,12,11,24,22,16,22,15,36,35,38,37,-1
,2025,sır,165,Dynamic,Cacak 94,96,89,24,28,26,18,28,18,18,25,52,44,46,43,1
,2025,sır,176,OKK Novi Pazar,x,111,75,24,21,25,23,28,13,34,18,45,48,41,52,1
,2025,sır,164,Joker,x,94,85,28,26,22,23,22,17,22,19,54,45,39,41,-1
,2025,sır,161,Radnicki,x,72,98,16,23,17,21,16,36,23,18,39,38,52,41,1
,2025,sır,162,BBK Radnicki,x,88,84,19,20,29,17,23,21,17,26,39,46,44,43,1
,2025,sır,166,Vojvodina Novi Sad,x,67,80,21,22,11,26,24,18,11,14,43,37,42,25,-1
,2025,sır,161,Mladost Zemun,x,70,91,17,26,13,23,21,20,19,22,43,36,41,41,1
,2025,sır,165,Vrsac,x,79,67,24,12,11,24,22,16,22,15,36,35,38,37,-1
,2025,sır,165,Cacak 94,x,96,89,24,28,26,18,28,18,18,25,52,44,46,43,1
,2025,sloven,154,Tajfun Sentjur,Podcetrtek,84,72,22,16,18,16,21,27,23,13,38,34,48,36,1
,2025,sloven,151,Helios Domzale,LTH Castings,94,56,15,19,25,16,31,8,23,13,34,41,39,36,-1
,2025,sloven,149,KK Triglav Kranj,Sencur,87,63,26,10,24,16,17,19,20,18,36,40,36,38,-1
,2025,sloven,156,KK Krka Novo mesto,Rogaska,97,67,20,26,24,17,29,4,24,20,46,41,33,44,-1
,2025,sloven,154,Podcetrtek,x,84,72,22,16,18,16,21,27,23,13,38,34,48,36,1
,2025,sloven,151,LTH Castings,x,94,56,15,19,25,16,31,8,23,13,34,41,39,36,-1
,2025,sloven,149,Sencur,x,87,63,26,10,24,16,17,19,20,18,36,40,36,38,-1
,2025,sloven,156,Rogaska,x,97,67,20,26,24,17,29,4,24,20,46,41,33,44,-1
,2025,slovak,163,Levice,BC Komarno,120,76,36,12,29,24,31,19,24,21,48,53,50,45,1
,2025,slovak,163,MBK Handlova,BKM Lucenec,86,77,14,14,20,20,28,25,24,18,28,40,53,42,1
,2025,slovak,167,Spisski Rytieri,BC Prievidza,92,84,27,29,19,21,25,10,21,24,56,40,35,45,-1
,2025,slovak,163,Inter Bratislava,Nitra Blue Wings,83,79,20,22,22,20,16,17,25,20,42,42,33,45,-1
,2025,slovak,163,BC Komarno,x,120,76,36,12,29,24,31,19,24,21,48,53,50,45,1
,2025,slovak,163,BKM Lucenec,x,86,77,14,14,20,20,28,25,24,18,28,40,53,42,1
,2025,slovak,167,BC Prievidza,x,92,84,27,29,19,21,25,10,21,24,56,40,35,45,-1
,2025,slovak,163,Nitra Blue Wings,x,83,79,20,22,22,20,16,17,25,20,42,42,33,45,-1
,2025,rom,166,CSM Targu Mures,BC Steaua Bucuresti,96,94,23,24,23,28,27,19,23,23,47,51,46,46,1
,2025,rom,163,Corona Brasov,Cluj-Napoca,67,107,20,24,15,24,22,30,10,29,44,39,52,39,1
,2025,rom,157,CSU Sibiu,CSM Oradea,64,93,13,21,15,23,17,28,19,21,34,38,45,40,1
,2025,rom,165,CSM Constanta,Petrolul Ploiesti,82,72,17,26,26,25,21,8,18,13,43,51,29,31,-1
,2025,rom,162,Dinamo Bucharest,Voluntari,69,88,19,21,21,14,8,26,21,27,40,35,34,48,1
,2025,rom,168,Municipal Galati,SCM Timisoara,84,69,28,16,20,17,12,19,24,17,44,37,31,41,-1
,2025,rom,150,Rapid Bucuresti,Arges Pitesti,79,73,23,23,14,20,24,16,18,14,46,34,40,32,-1
,2025,rom,156,SCM Craiova,Valcea,95,73,35,13,22,20,16,21,22,19,48,42,37,41,-1
,2025,rom,165,Valcea,CSM Targu Mures,99,92,29,24,29,26,20,17,21,25,53,55,37,46,1
,2025,rom,166,BC Steaua Bucuresti,x,96,94,23,24,23,28,27,19,23,23,47,51,46,46,1
,2025,rom,163,Cluj-Napoca,x,67,107,20,24,15,24,22,30,10,29,44,39,52,39,1
,2025,rom,157,CSM Oradea,x,64,93,13,21,15,23,17,28,19,21,34,38,45,40,1
,2025,rom,165,Petrolul Ploiesti,x,82,72,17,26,26,25,21,8,18,13,43,51,29,31,-1
,2025,rom,162,Voluntari,x,69,88,19,21,21,14,8,26,21,27,40,35,34,48,1
,2025,rom,168,SCM Timisoara,x,84,69,28,16,20,17,12,19,24,17,44,37,31,41,-1
,2025,rom,150,Arges Pitesti,x,79,73,23,23,14,20,24,16,18,14,46,34,40,32,-1
,2025,rom,156,Valcea,x,95,73,35,13,22,20,16,21,22,19,48,42,37,41,-1
,2025,rom,165,CSM Targu Mures,x,99,92,29,24,29,26,20,17,21,25,53,55,37,46,1
,2025,rus,145,Metallurg,Khimki M.,68,80,22,20,20,26,19,17,7,17,42,46,36,24,-1
,2025,rus,149,Dome-Springs Izhevsk,Lokomotiv Kuban 2,97,103,17,18,24,20,15,16,23,25,35,44,31,48,1
,2025,rus,160,CSKA Moscow 2,Zenit Petersburg 2,86,82,24,20,14,20,23,17,25,25,44,34,40,50,1
,2025,rus,152,Tambov,Dynamo Grozny,77,64,24,12,19,20,15,15,19,17,36,39,30,36,-1
,2025,rus,148,Dome-Springs Izhevsk,Bars Rostov,66,76,18,12,15,22,16,23,17,19,30,37,39,36,1
,2025,rus,145,Chelyabinsk,University-Ugra,73,70,22,13,13,17,12,19,26,21,35,30,31,47,1
,2025,rus,156,Temp Sumz Revda,Lokomotiv Kuban 2,87,79,30,17,19,32,16,15,22,15,47,51,31,37,-1
,2025,rus,147,Irkutsk,Novosibirsk,79,81,18,27,20,18,13,19,28,17,45,38,32,45,1
,2025,rus,158,Dynamo Vladivostok,Barnaul,79,75,22,18,12,13,24,25,21,19,40,25,49,40,1
,2025,rus,145,Khimki M.,x,68,80,22,20,20,26,19,17,7,17,42,46,36,24,-1
,2025,rus,149,Lokomotiv Kuban 2,x,97,103,17,18,24,20,15,16,23,25,35,44,31,48,1
,2025,rus,160,Zenit Petersburg 2,x,86,82,24,20,14,20,23,17,25,25,44,34,40,50,1
,2025,rus,152,Dynamo Grozny,x,77,64,24,12,19,20,15,15,19,17,36,39,30,36,-1
,2025,rus,148,Bars Rostov,x,66,76,18,12,15,22,16,23,17,19,30,37,39,36,1
,2025,rus,145,University-Ugra,x,73,70,22,13,13,17,12,19,26,21,35,30,31,47,1
,2025,rus,156,Lokomotiv Kuban 2,x,87,79,30,17,19,32,16,15,22,15,47,51,31,37,-1
,2025,rus,147,Novosibirsk,x,79,81,18,27,20,18,13,19,28,17,45,38,32,45,1
,2025,rus,158,Barnaul,x,79,75,22,18,12,13,24,25,21,19,40,25,49,40,1
,2025,swit,158,Lausanne Basket,Sdent BBC Nyon,94,78,29,16,27,24,14,17,24,21,45,51,31,45,-1
,2025,swit,157,Regio Basel,Geneva Lions,83,85,18,23,23,27,23,18,19,17,41,50,41,36,-1
,2025,swit,167,SAM Massagno,Lugano Tigers,104,91,13,30,28,17,30,25,33,19,43,45,55,52,1
,2025,swit,167,Fribourg Olympic,BBC Monthey,106,90,30,26,34,16,23,25,19,23,56,50,48,42,1
,2025,swit,158,Sdent BBC Nyon,x,94,78,29,16,27,24,14,17,24,21,45,51,31,45,-1
,2025,swit,157,Geneva Lions,x,83,85,18,23,23,27,23,18,19,17,41,50,41,36,-1
,2025,swit,167,Lugano Tigers,x,104,91,13,30,28,17,30,25,33,19,43,45,55,52,1
,2025,swit,167,BBC Monthey,x,106,90,30,26,34,16,23,25,19,23,56,50,48,42,1
,2025,tur,165,Fenerbahce,Anadolu Efes,86,72,21,21,28,14,18,15,19,22,42,42,33,41,-1
,2025,tur,168,Merkezefendi,Bursaspor,74,88,13,18,23,18,17,28,21,24,31,41,45,45,1
,2025,tur,175,Tofas,Petkim Spor,107,99,28,22,21,22,26,24,32,31,50,43,50,63,1
,2025,tur,163,Bahcesehir Kol.,Darussafaka,84,73,16,19,22,12,24,18,22,24,35,34,42,46,1
,2025,tur,163,Turk Telekom,Manisa,80,85,18,20,22,11,18,17,22,37,38,33,35,59,1
,2025,tur,169,Besiktas,Buyukcekmece,95,84,24,25,27,23,23,19,21,17,49,50,42,38,-1
,2025,tur,171,Karsiyaka,Yalovaspor,104,81,34,25,30,15,28,21,12,20,59,45,49,32,-1
,2025,tur,165,Galatasaray,Mersin SK,101,82,26,22,27,15,23,22,25,23,48,42,45,48,1
,2025,tur b,160,Harem Spor,Balikesir,94,93,21,22,23,23,23,19,27,29,43,46,42,56,1
,2025,tur b,165,Trabzonspor,Cayirova,85,68,21,20,30,14,16,8,18,26,41,44,24,44,-1
,2025,tur b,164,MKE Ankaragucu,Esenler Erokspor,78,84,28,31,20,12,13,19,17,22,59,32,32,39,-1
,2025,tur b,158,Çağdaş Bodrum Spor,Gaziantep,103,94,32,25,14,25,28,21,29,23,57,39,49,52,1
,2025,tur b,155,Fenerbahce 2,CO Basket,87,93,15,21,24,25,21,19,21,16,36,49,40,37,-1
,2025,tur b,151,Bordo Sportif,iLab Basketbol,93,84,18,20,30,19,25,25,20,20,38,49,50,40,1
,2025,tur b,163,Konya BBSK,Istanbul Anka Spor,106,64,22,15,20,18,37,16,27,15,37,38,53,42,1
,2025,tur b,164,Kapakli Spor,OGM Ormanspor,111,84,23,21,32,32,26,18,30,13,44,64,44,43,1
,2025,tur b,152,Final Spor,Ankara Kolejliler,60,70,25,21,13,21,14,13,8,15,46,34,27,23,-1
,2025,tur,165,Anadolu Efes,x,86,72,21,21,28,14,18,15,19,22,42,42,33,41,-1
,2025,tur,168,Bursaspor,x,74,88,13,18,23,18,17,28,21,24,31,41,45,45,1
,2025,tur,175,Petkim Spor,x,107,99,28,22,21,22,26,24,32,31,50,43,50,63,1
,2025,tur,163,Darussafaka,x,84,73,16,19,22,12,24,18,22,24,35,34,42,46,1
,2025,tur,163,Manisa,x,80,85,18,20,22,11,18,17,22,37,38,33,35,59,1
,2025,tur,169,Buyukcekmece,x,95,84,24,25,27,23,23,19,21,17,49,50,42,38,-1
,2025,tur,171,Yalovaspor,x,104,81,34,25,30,15,28,21,12,20,59,45,49,32,-1
,2025,tur,165,Mersin SK,x,101,82,26,22,27,15,23,22,25,23,48,42,45,48,1
,2025,tur b,160,Balikesir,x,94,93,21,22,23,23,23,19,27,29,43,46,42,56,1
,2025,tur b,165,Cayirova,x,85,68,21,20,30,14,16,8,18,26,41,44,24,44,-1
,2025,tur b,164,Esenler Erokspor,x,78,84,28,31,20,12,13,19,17,22,59,32,32,39,-1
,2025,tur b,158,Gaziantep,x,103,94,32,25,14,25,28,21,29,23,57,39,49,52,1
,2025,tur b,155,CO Basket,x,87,93,15,21,24,25,21,19,21,16,36,49,40,37,-1
,2025,tur b,151,iLab Basketbol,x,93,84,18,20,30,19,25,25,20,20,38,49,50,40,1
,2025,tur b,163,Istanbul Anka Spor,x,106,64,22,15,20,18,37,16,27,15,37,38,53,42,1
,2025,tur b,164,OGM Ormanspor,x,111,84,23,21,32,32,26,18,30,13,44,64,44,43,1
,2025,tur b,152,Ankara Kolejliler,x,60,70,25,21,13,21,14,13,8,15,46,34,27,23,-1
,2025,ukr,144,Rivne,Goverla,69,59,16,13,20,19,22,20,11,7,29,39,42,18,-1
,2025,ukr,145,Kyiv Basket,Stariy Lutsk,84,74,21,19,14,25,16,15,14,6,40,39,31,20,-1
,2025,ukr,148,BC Dnipro,BK Zaporozhye,73,61,16,15,17,21,17,6,23,19,31,38,23,42,-1
,2025,ukr,147,Rivne,Kyiv Basket,47,62,9,15,14,22,8,12,16,13,24,36,20,29,-1
,2025,ukr,140,Stariy Lutsk,Goverla,75,73,12,20,27,24,21,21,15,8,32,51,42,23,-1
,2025,ukr,144,Goverla,x,69,59,16,13,20,19,22,20,11,7,29,39,42,18,-1
,2025,ukr,145,Stariy Lutsk,x,84,74,21,19,14,25,16,15,14,6,40,39,31,20,-1
,2025,ukr,148,BK Zaporozhye,x,73,61,16,15,17,21,17,6,23,19,31,38,23,42,-1
,2025,ukr,147,Kyiv Basket,x,47,62,9,15,14,22,8,12,16,13,24,36,20,29,-1
,2025,ukr,140,Goverla,x,75,73,12,20,27,24,21,21,15,8,32,51,42,23,-1
,2025,vtb,151,Samara,MBA Moscow,101,88,23,25,30,29,22,17,26,17,48,59,39,43,1
,2025,vtb,162,Lokomotiv Kuban,Saratov,83,64,15,15,20,19,24,17,24,13,30,39,41,37,-1
,2025,vtb,158,Parma Perm,Zenit Petersburg,74,86,16,23,21,23,16,21,21,19,39,44,37,40,-1
,2025,vtb,155,Uralmash Ekaterinburg,Nizhny Novgorod,93,81,24,15,22,16,14,17,17,29,39,38,31,46,-1
,2025,vtb,150,Unics Kazan,Enisey,96,74,24,19,25,17,19,17,28,21,43,42,36,49,1
,2025,vtb,157,CSKA Moscow,Astana,110,50,26,14,32,11,20,13,32,12,40,43,33,44,-1
,2025,vtb,157,MBA Moscow,Zenit Petersburg,68,89,16,25,24,22,22,23,6,19,41,46,45,25,-1
,2025,vtb,155,Samara,Unics Kazan,62,86,10,22,21,22,17,23,14,19,32,43,40,33,-1
,2025,vtb,154,Parma Perm,Saratov,71,76,19,14,17,23,14,20,21,19,33,40,34,40,-1
,2025,vtb,152,Nizhny Novgorod,Astana,87,69,23,19,20,18,25,14,19,18,42,38,39,37,-1
,2025,vtb,159,Uralmash Ekaterinburg,CSKA Moscow,70,77,16,20,17,17,19,20,18,20,36,34,39,38,-1
,2025,vtb,159,Enisey,Lokomotiv Kuban,70,73,18,21,19,14,14,17,19,21,39,33,31,40,-1
,2025,vtb,151,MBA Moscow,x,101,88,23,25,30,29,22,17,26,17,48,59,39,43,1
,2025,vtb,162,Saratov,x,83,64,15,15,20,19,24,17,24,13,30,39,41,37,-1
,2025,vtb,158,Zenit Petersburg,x,74,86,16,23,21,23,16,21,21,19,39,44,37,40,-1
,2025,vtb,155,Nizhny Novgorod,x,93,81,24,15,22,16,14,17,17,29,39,38,31,46,-1
,2025,vtb,150,Enisey,x,96,74,24,19,25,17,19,17,28,21,43,42,36,49,1
,2025,vtb,157,Astana,x,110,50,26,14,32,11,20,13,32,12,40,43,33,44,-1
,2025,vtb,157,Zenit Petersburg,x,68,89,16,25,24,22,22,23,6,19,41,46,45,25,-1
,2025,vtb,155,Unics Kazan,x,62,86,10,22,21,22,17,23,14,19,32,43,40,33,-1
,2025,vtb,154,Saratov,x,71,76,19,14,17,23,14,20,21,19,33,40,34,40,-1
,2025,vtb,152,Astana,x,87,69,23,19,20,18,25,14,19,18,42,38,39,37,-1
,2025,vtb,159,CSKA Moscow,x,70,77,16,20,17,17,19,20,18,20,36,34,39,38,-1
,2025,vtb,159,Lokomotiv Kuban,x,70,73,18,21,19,14,14,17,19,21,39,33,31,40,-1